a	a˧˧
ai	aj˧˧
am	am˧˧
an	an˧˧
ang	aŋ˧˧
anh	ɛŋ˧˧
ao	aw˧˧
au	ăw˧˧
ay	ăj˧˧
ba	ba˧˧
bai	baj˧˧
bam	bam˧˧
ban	ban˧˧
bang	baŋ˧˧
banh	bɛŋ˧˧
bao	baw˧˧
bau	băw˧˧
bay	băj˧˧
be	bɛ˧˧
bem	bɛm˧˧
ben	bɛn˧˧
beng	bɛŋ˧˧
beo	beo˧˧
bi	bi˧˧
bia	biə˧˧
bin	bin˧˧
binh	biŋ˧˧
biên	biən˧˧
biêng	biəŋ˧˧
biêt	biət˧˧
biêu	biəw˧˧
biếc	biək˦˥
biếm	biəm˨˦
biến	biən˨˦
biếng	biəŋ˨˦
biết	biət˦˥
biếu	biəw˨˦
biền	biən˧˨
biều	biəw˧˨
biển	biən˧˩˨
biểu	biəw˧˩˨
biện	biən˨ˀ˩ʔ
biệt	biət˨ˀ˩
bo	bɔ˧˧
boa	bwa˧˧
bom	bɔm˧˧
bon	bɔn˧˧
bong	bɔŋ͡m˧˧
boong	bɔɔŋ͡m˧˧
boóc	bɔɔk͡p˦˥
boóng	bɔɔŋ͡m˨˦
bu	bu˧˧
bua	buə˧˧
bui	buj˧˧
bum	bum˧˧
bun	bun˧˧
bung	buŋ͡m˧˧
buy	bwi˧˧
buôi	buəj˧˧
buôn	buən˧˧
buông	buəŋ˧˧
buýp	bwip˦˥
buýt	bwit˦˥
buốt	buət˦˥
buồi	buəj˧˨
buồm	buəm˧˨
buồn	buən˧˨
buồng	buəŋ˧˨
buổi	buəj˧˩˨
buộc	buək˨ˀ˩
buộm	buəm˨ˀ˩ʔ
buột	buət˨ˀ˩
bà	ba˧˨
bài	baj˧˨
bàm	bam˧˨
bàn	ban˧˨
bàng	baŋ˧˨
bành	bɛŋ˧˨
bào	baw˧˨
bàu	băw˧˨
bày	băj˧˨
bá	ba˨˦
bác	bak˦˥
bách	bɛk˦˥
bái	baj˨˦
bám	bam˨˦
bán	ban˨˦
báng	baŋ˨˦
bánh	bɛŋ˨˦
báo	baw˨˦
báp	bap˦˥
bát	bat˦˥
báu	băw˨˦
báy	băj˨˦
bân	bɤ̆n˧˧
bâng	bɤ̆ŋ˧˧
bâu	bɤ̆w˧˧
bây	bɤ̆j˧˧
bã	ba˧ˀ˥
bãi	baj˧ˀ˥
bão	baw˧ˀ˥
bè	bɛ˧˨
bèm	bɛm˧˨
bèn	bɛn˧˨
bèo	beo˧˨
bé	bɛ˨˦
béc	bɛk˦˥
bén	bɛn˨˦
béng	bɛŋ˨˦
béo	beo˨˦
bép	bɛp˦˥
bét	bɛt˦˥
bê	be˧˧
bên	ben˧˧
bênh	beŋ˧˧
bêu	bɛu˧˧
bì	bi˧˨
bìa	biə˧˨
bìm	bim˧˨
bình	biŋ˧˨
bìu	biw˧˨
bí	bi˨˦
bích	bik˦˥
bím	bim˨˦
bín	bin˨˦
bính	biŋ˨˦
bíp	bip˦˥
bít	bit˦˥
bíu	biw˨˦
bò	bɔ˧˨
bòi	bɔj˧˨
bòm	bɔm˧˨
bòn	bɔn˧˨
bòng	bɔŋ͡m˧˨
bó	bɔ˨˦
bóc	bɔk͡p˦˥
bói	bɔj˨˦
bón	bɔn˨˦
bóng	bɔŋ͡m˨˦
bóp	bɔp˦˥
bót	bɔt˦˥
bô	bo˧˧
bôi	boj˧˧
bôm	bom˧˧
bôn	bon˧˧
bông	boŋ͡m˧˧
bõ	bɔ˧ˀ˥
bõm	bɔm˧ˀ˥
bõng	bɔŋ͡m˧ˀ˥
bù	bu˧˨
bùa	buə˧˨
bùi	buj˧˨
bùm	bum˧˨
bùn	bun˧˨
bùng	buŋ͡m˧˨
bú	bu˨˦
búa	buə˨˦
búc	buk͡p˦˥
búi	buj˨˦
bún	bun˨˦
búng	buŋ͡m˨˦
búp	bup˦˥
bút	but˦˥
băm	băm˧˧
băn	băn˧˧
băng	băŋ˧˧
bĩ	bi˧ˀ˥
bĩnh	biŋ˧ˀ˥
bĩu	biw˧ˀ˥
bũm	bum˧ˀ˥
bơ	bɤ˧˧
bơi	bɤj˧˧
bơm	bɤm˧˧
bơn	bɤn˧˧
bư	bɯ˧˧
bưa	bɯə˧˧
bưng	bɯŋ˧˧
bưu	bɯw˧˧
bươi	bɯəj˧˧
bươm	bɯəm˧˧
bươn	bɯən˧˧
bương	bɯəŋ˧˧
bươu	bɯəw˧˧
bước	bɯək˦˥
bướm	bɯəm˨˦
bướng	bɯəŋ˨˦
bướp	bɯəp˦˥
bướu	bɯəw˨˦
bưởi	bɯəj˧˩˨
bượt	bɯət˨ˀ˩
bạ	ba˨ˀ˩ʔ
bạc	bak˨ˀ˩
bạch	bɛk˨ˀ˩
bại	baj˨ˀ˩ʔ
bạm	bam˨ˀ˩ʔ
bạn	ban˨ˀ˩ʔ
bạng	baŋ˨ˀ˩ʔ
bạnh	bɛŋ˨ˀ˩ʔ
bạo	baw˨ˀ˩ʔ
bạp	bap˨ˀ˩
bạt	bat˨ˀ˩
bạu	băw˨ˀ˩ʔ
bả	ba˧˩˨
bải	baj˧˩˨
bản	ban˧˩˨
bảng	baŋ˧˩˨
bảnh	bɛŋ˧˩˨
bảo	baw˧˩˨
bảu	băw˧˩˨
bảy	băj˧˩˨
bấc	bɤ̆k˦˥
bấm	bɤ̆m˨˦
bấn	bɤ̆n˨˦
bấng	bɤ̆ŋ˨˦
bấp	bɤ̆p˦˥
bất	bɤ̆t˦˥
bấu	bɤ̆w˨˦
bấy	bɤ̆j˨˦
bầm	bɤ̆m˧˨
bần	bɤ̆n˧˨
bầng	bɤ̆ŋ˧˨
bầu	bɤ̆w˧˨
bầy	bɤ̆j˧˨
bẩm	bɤ̆m˧˩˨
bẩn	bɤ̆n˧˩˨
bẩu	bɤ̆w˧˩˨
bẩy	bɤ̆j˧˩˨
bẫm	bɤ̆m˧ˀ˥
bẫy	bɤ̆j˧ˀ˥
bậc	bɤ̆k˨ˀ˩
bậm	bɤ̆m˨ˀ˩ʔ
bận	bɤ̆n˨ˀ˩ʔ
bậng	bɤ̆ŋ˨ˀ˩ʔ
bập	bɤ̆p˨ˀ˩
bật	bɤ̆t˨ˀ˩
bậu	bɤ̆w˨ˀ˩ʔ
bậy	bɤ̆j˨ˀ˩ʔ
bắc	băk˦˥
bắn	băn˨˦
bắng	băŋ˨˦
bắp	băp˦˥
bắt	băt˦˥
bằm	băm˧˨
bằn	băn˧˨
bằng	băŋ˧˨
bẳm	băm˧˩˨
bẳn	băn˧˩˨
bẵm	băm˧ˀ˥
bẵng	băŋ˧ˀ˥
bặc	băk˨ˀ˩
bặm	băm˨ˀ˩ʔ
bặn	băn˨ˀ˩ʔ
bặng	băŋ˨ˀ˩ʔ
bặp	băp˨ˀ˩
bặt	băt˨ˀ˩
bẹ	bɛ˨ˀ˩ʔ
bẹn	bɛn˨ˀ˩ʔ
bẹo	beo˨ˀ˩ʔ
bẹp	bɛp˨ˀ˩
bẹt	bɛt˨ˀ˩
bẻ	bɛ˧˩˨
bẻm	bɛm˧˩˨
bẻo	beo˧˩˨
bẽ	bɛ˧ˀ˥
bẽn	bɛn˧ˀ˥
bẽo	beo˧ˀ˥
bế	be˨˦
bến	ben˨˦
bếnh	beŋ˨˦
bếp	bep˦˥
bết	bet˦˥
bề	be˧˨
bền	ben˧˨
bềnh	beŋ˧˨
bều	bɛu˧˨
bể	be˧˩˨
bển	ben˧˩˨
bểnh	beŋ˧˩˨
bễ	be˧ˀ˥
bệ	be˨ˀ˩ʔ
bệch	bek˨ˀ˩
bện	ben˨ˀ˩ʔ
bệnh	beŋ˨ˀ˩ʔ
bệp	bep˨ˀ˩
bệt	bet˨ˀ˩
bệu	bɛu˨ˀ˩ʔ
bỉ	bi˧˩˨
bỉm	bim˧˩˨
bỉnh	biŋ˧˩˨
bỉu	biw˧˩˨
bị	bi˨ˀ˩ʔ
bịa	biə˨ˀ˩ʔ
bịch	bik˨ˀ˩
bịn	bin˨ˀ˩ʔ
bịnh	biŋ˨ˀ˩ʔ
bịp	bip˨ˀ˩
bịt	bit˨ˀ˩
bịu	biw˨ˀ˩ʔ
bọ	bɔ˨ˀ˩ʔ
bọc	bɔk͡p˨ˀ˩
bọn	bɔn˨ˀ˩ʔ
bọng	bɔŋ͡m˨ˀ˩ʔ
bọp	bɔp˨ˀ˩
bọt	bɔt˨ˀ˩
bỏ	bɔ˧˩˨
bỏi	bɔj˧˩˨
bỏm	bɔm˧˩˨
bỏn	bɔn˧˩˨
bỏng	bɔŋ͡m˧˩˨
bố	bo˨˦
bốc	bok͡p˦˥
bối	boj˨˦
bốn	bon˨˦
bống	boŋ͡m˨˦
bốp	bop˦˥
bốt	bot˦˥
bồ	bo˧˨
bồi	boj˧˨
bồm	bom˧˨
bồn	bon˧˨
bồng	boŋ͡m˧˨
bổ	bo˧˩˨
bổi	boj˧˩˨
bổn	bon˧˩˨
bổng	boŋ͡m˧˩˨
bỗ	bo˧ˀ˥
bỗm	bom˧ˀ˥
bỗng	boŋ͡m˧ˀ˥
bộ	bo˨ˀ˩ʔ
bộc	bok͡p˨ˀ˩
bội	boj˨ˀ˩ʔ
bộn	bon˨ˀ˩ʔ
bộng	boŋ͡m˨ˀ˩ʔ
bộp	bop˨ˀ˩
bột	bot˨ˀ˩
bớ	bɤ˨˦
bới	bɤj˨˦
bớn	bɤn˨˦
bớp	bɤp˦˥
bớt	bɤt˦˥
bờ	bɤ˧˨
bời	bɤj˧˨
bờm	bɤm˧˨
bờn	bɤn˧˨
bở	bɤ˧˩˨
bởi	bɤj˧˩˨
bỡ	bɤ˧ˀ˥
bỡn	bɤn˧ˀ˥
bợ	bɤ˨ˀ˩ʔ
bợm	bɤm˨ˀ˩ʔ
bợn	bɤn˨ˀ˩ʔ
bợp	bɤp˨ˀ˩
bợt	bɤt˨ˀ˩
bụ	bu˨ˀ˩ʔ
bụa	buə˨ˀ˩ʔ
bục	buk͡p˨ˀ˩
bụi	buj˨ˀ˩ʔ
bụm	bum˨ˀ˩ʔ
bụng	buŋ͡m˨ˀ˩ʔ
bụp	bup˨ˀ˩
bụt	but˨ˀ˩
bủ	bu˧˩˨
bủa	buə˧˩˨
bủm	bum˧˩˨
bủn	bun˧˩˨
bủng	buŋ͡m˧˩˨
bứ	bɯ˨˦
bứa	bɯə˨˦
bức	bɯk˦˥
bứng	bɯŋ˨˦
bứt	bɯt˦˥
bừ	bɯ˧˨
bừa	bɯə˧˨
bừng	bɯŋ˧˨
bửa	bɯə˧˩˨
bửng	bɯŋ˧˩˨
bửu	bɯw˧˩˨
bữa	bɯə˧ˀ˥
bự	bɯ˨ˀ˩ʔ
bựa	bɯə˨ˀ˩ʔ
bực	bɯk˨ˀ˩
bựng	bɯŋ˨ˀ˩ʔ
bựt	bɯt˨ˀ˩
ca	ka˧˧
cai	kaj˧˧
cam	kam˧˧
can	kan˧˧
cang	kaŋ˧˧
canh	kɛŋ˧˧
cao	kaw˧˧
cau	kăw˧˧
cay	kăj˧˧
cen	kɛn˧˧
cha	ca˧˧
chai	caj˧˧
cham	cam˧˧
chan	can˧˧
chang	caŋ˧˧
chanh	cɛŋ˧˧
chao	caw˧˧
chau	căw˧˧
chay	căj˧˧
che	cɛ˧˧
chem	cɛm˧˧
chen	cɛn˧˧
cheng	cɛŋ˧˧
cheo	ceo˧˧
chi	ci˧˧
chia	ciə˧˧
chim	cim˧˧
chin	cin˧˧
chinh	ciŋ˧˧
chiu	ciw˧˧
chiêm	ciəm˧˧
chiên	ciən˧˧
chiêng	ciəŋ˧˧
chiêu	ciəw˧˧
chiếc	ciək˦˥
chiếm	ciəm˨˦
chiến	ciən˨˦
chiếng	ciəŋ˨˦
chiếp	ciəp˦˥
chiết	ciət˦˥
chiếu	ciəw˨˦
chiền	ciən˧˨
chiềng	ciəŋ˧˨
chiều	ciəw˧˨
chiểu	ciəw˧˩˨
chiệc	ciək˨ˀ˩
chiện	ciən˨ˀ˩ʔ
cho	cɔ˧˧
choa	cwa˧˧
choai	cwaj˧˧
choang	cwaŋ˧˧
choe	cwe˧˧
choen	cwen˧˧
choi	cɔj˧˧
chom	cɔm˧˧
chon	cɔn˧˧
chong	cɔŋ͡m˧˧
choài	cwaj˧˨
choàm	cwam˧˨
choàng	cwaŋ˧˨
choá	cwa˨˦
choác	cwak˦˥
choái	cwaj˨˦
choán	cwan˨˦
choáng	cwaŋ˨˦
choãi	cwaj˧ˀ˥
choè	cwe˧˨
choèn	cwen˧˨
choé	cwe˨˦
choét	cwet˦˥
choòng	cɔɔŋ͡m˧˨
choăn	cwăn˧˧
choạc	cwak˨ˀ˩
choại	cwaj˨ˀ˩ʔ
choạng	cwaŋ˨ˀ˩ʔ
choạp	cwap˨ˀ˩
choảng	cwaŋ˧˩˨
choắt	cwăt˦˥
choẹ	cwe˨ˀ˩ʔ
choẹt	cwet˨ˀ˩
chu	cu˧˧
chua	cuə˧˧
chui	cuj˧˧
chum	cum˧˧
chun	cun˧˧
chung	cuŋ͡m˧˧
chuyên	cwiən˧˧
chuyến	cwiən˨˦
chuyền	cwiən˧˨
chuyển	cwiən˧˩˨
chuyện	cwiən˨ˀ˩ʔ
chuôi	cuəj˧˧
chuôm	cuəm˧˧
chuông	cuəŋ˧˧
chuẩn	cwɤ̆n˧˩˨
chuế	cwe˨˦
chuếch	cwek˦˥
chuếnh	cweŋ˨˦
chuểnh	cweŋ˧˩˨
chuệch	cwek˨ˀ˩
chuệnh	cweŋ˨ˀ˩ʔ
chuốc	cuək˦˥
chuối	cuəj˨˦
chuốt	cuət˦˥
chuồi	cuəj˧˨
chuồn	cuən˧˨
chuồng	cuəŋ˧˨
chuỗi	cuəj˧ˀ˥
chuộc	cuək˨ˀ˩
chuội	cuəj˨ˀ˩ʔ
chuộng	cuəŋ˨ˀ˩ʔ
chuột	cuət˨ˀ˩
chuỳ	cwi˧˨
chà	ca˧˨
chài	caj˧˨
chàm	cam˧˨
chàng	caŋ˧˨
chành	cɛŋ˧˨
chào	caw˧˨
chàu	căw˧˨
chày	căj˧˨
chá	ca˨˦
chác	cak˦˥
chách	cɛk˦˥
chái	caj˨˦
chán	can˨˦
cháng	caŋ˨˦
chánh	cɛŋ˨˦
cháo	caw˨˦
chát	cat˦˥
cháu	căw˨˦
cháy	căj˨˦
châm	cɤ̆m˧˧
chân	cɤ̆n˧˧
châng	cɤ̆ŋ˧˧
châu	cɤ̆w˧˧
chây	cɤ̆j˧˧
chã	ca˧ˀ˥
chãi	caj˧ˀ˥
chão	caw˧ˀ˥
chè	cɛ˧˨
chèm	cɛm˧˨
chèn	cɛn˧˨
chèo	ceo˧˨
ché	cɛ˨˦
chém	cɛm˨˦
chén	cɛn˨˦
chéng	cɛŋ˨˦
chéo	ceo˨˦
chép	cɛp˦˥
chét	cɛt˦˥
chê	ce˧˧
chêm	cem˧˧
chênh	ceŋ˧˧
chêu	cɛu˧˧
chì	ci˧˨
chìa	ciə˧˨
chìm	cim˧˨
chình	ciŋ˧˨
chìu	ciw˧˨
chí	ci˨˦
chía	ciə˨˦
chích	cik˦˥
chím	cim˨˦
chín	cin˨˦
chính	ciŋ˨˦
chíp	cip˦˥
chít	cit˦˥
chíu	ciw˨˦
chò	cɔ˧˨
chòe	cwe˧˨
chòi	cɔj˧˨
chòm	cɔm˧˨
chòng	cɔŋ͡m˧˨
chó	cɔ˨˦
chóc	cɔk͡p˦˥
chóe	cwe˨˦
chói	cɔj˨˦
chóng	cɔŋ͡m˨˦
chóp	cɔp˦˥
chót	cɔt˦˥
chô	co˧˧
chôm	com˧˧
chôn	con˧˧
chông	coŋ͡m˧˧
chõ	cɔ˧ˀ˥
chõm	cɔm˧ˀ˥
chõng	cɔŋ͡m˧ˀ˥
chù	cu˧˨
chùa	cuə˧˨
chùi	cuj˧˨
chùm	cum˧˨
chùn	cun˧˨
chùng	cuŋ͡m˧˨
chùy	cwi˧˨
chú	cu˨˦
chúa	cuə˨˦
chúc	cuk͡p˦˥
chúi	cuj˨˦
chúm	cum˨˦
chúng	cuŋ͡m˨˦
chút	cut˦˥
chăm	căm˧˧
chăn	căn˧˧
chăng	căŋ˧˧
chĩa	ciə˧ˀ˥
chĩn	cin˧ˀ˥
chĩnh	ciŋ˧ˀ˥
chũi	cuj˧ˀ˥
chũm	cum˧ˀ˥
chũn	cun˧ˀ˥
chơ	cɤ˧˧
chơi	cɤj˧˧
chơm	cɤm˧˧
chơn	cɤn˧˧
chư	cɯ˧˧
chưa	cɯə˧˧
chưn	cɯn˧˧
chưng	cɯŋ˧˧
chương	cɯəŋ˧˧
chước	cɯək˦˥
chướng	cɯəŋ˨˦
chườm	cɯəm˧˨
chường	cɯəŋ˧˨
chưởi	cɯəj˧˩˨
chưởng	cɯəŋ˧˩˨
chưỡng	cɯəŋ˧ˀ˥
chược	cɯək˨ˀ˩
chượp	cɯəp˨ˀ˩
chạ	ca˨ˀ˩ʔ
chạc	cak˨ˀ˩
chạch	cɛk˨ˀ˩
chạm	cam˨ˀ˩ʔ
chạn	can˨ˀ˩ʔ
chạng	caŋ˨ˀ˩ʔ
chạnh	cɛŋ˨ˀ˩ʔ
chạo	caw˨ˀ˩ʔ
chạp	cap˨ˀ˩
chạt	cat˨ˀ˩
chạy	căj˨ˀ˩ʔ
chả	ca˧˩˨
chải	caj˧˩˨
chảm	cam˧˩˨
chảng	caŋ˧˩˨
chảnh	cɛŋ˧˩˨
chảo	caw˧˩˨
chảu	căw˧˩˨
chảy	căj˧˩˨
chấm	cɤ̆m˨˦
chấn	cɤ̆n˨˦
chấp	cɤ̆p˦˥
chất	cɤ̆t˦˥
chấu	cɤ̆w˨˦
chấy	cɤ̆j˨˦
chầm	cɤ̆m˧˨
chần	cɤ̆n˧˨
chầu	cɤ̆w˧˨
chầy	cɤ̆j˧˨
chẩm	cɤ̆m˧˩˨
chẩn	cɤ̆n˧˩˨
chẩu	cɤ̆w˧˩˨
chẫm	cɤ̆m˧ˀ˥
chẫn	cɤ̆n˧ˀ˥
chẫu	cɤ̆w˧ˀ˥
chậc	cɤ̆k˨ˀ˩
chậm	cɤ̆m˨ˀ˩ʔ
chận	cɤ̆n˨ˀ˩ʔ
chập	cɤ̆p˨ˀ˩
chật	cɤ̆t˨ˀ˩
chậu	cɤ̆w˨ˀ˩ʔ
chậy	cɤ̆j˨ˀ˩ʔ
chắc	căk˦˥
chắm	căm˨˦
chắn	căn˨˦
chắp	căp˦˥
chắt	căt˦˥
chằm	căm˧˨
chằn	căn˧˨
chằng	căŋ˧˨
chẳng	căŋ˧˩˨
chẵn	căn˧ˀ˥
chặc	căk˨ˀ˩
chặm	căm˨ˀ˩ʔ
chặn	căn˨ˀ˩ʔ
chặng	căŋ˨ˀ˩ʔ
chặp	căp˨ˀ˩
chặt	căt˨ˀ˩
chẹn	cɛn˨ˀ˩ʔ
chẹo	ceo˨ˀ˩ʔ
chẹp	cɛp˨ˀ˩
chẹt	cɛt˨ˀ˩
chẻ	cɛ˧˩˨
chẻm	cɛm˧˩˨
chẻn	cɛn˧˩˨
chẻng	cɛŋ˧˩˨
chẻo	ceo˧˩˨
chẽ	cɛ˧ˀ˥
chẽm	cɛm˧ˀ˥
chẽn	cɛn˧ˀ˥
chế	ce˨˦
chếch	cek˦˥
chếnh	ceŋ˨˦
chếp	cep˦˥
chết	cet˦˥
chề	ce˧˨
chềm	cem˧˨
chềnh	ceŋ˧˨
chểnh	ceŋ˧˩˨
chễm	cem˧ˀ˥
chễnh	ceŋ˧ˀ˥
chệ	ce˨ˀ˩ʔ
chệch	cek˨ˀ˩
chệm	cem˨ˀ˩ʔ
chện	cen˨ˀ˩ʔ
chệnh	ceŋ˨ˀ˩ʔ
chệp	cep˨ˀ˩
chệt	cet˨ˀ˩
chỉ	ci˧˩˨
chỉa	ciə˧˩˨
chỉn	cin˧˩˨
chỉnh	ciŋ˧˩˨
chị	ci˨ˀ˩ʔ
chịa	ciə˨ˀ˩ʔ
chịn	cin˨ˀ˩ʔ
chịt	cit˨ˀ˩
chịu	ciw˨ˀ˩ʔ
chọ	cɔ˨ˀ˩ʔ
chọc	cɔk͡p˨ˀ˩
chọe	cwe˨ˀ˩ʔ
chọi	cɔj˨ˀ˩ʔ
chọn	cɔn˨ˀ˩ʔ
chọp	cɔp˨ˀ˩
chọt	cɔt˨ˀ˩
chỏ	cɔ˧˩˨
chỏi	cɔj˧˩˨
chỏm	cɔm˧˩˨
chỏn	cɔn˧˩˨
chỏng	cɔŋ͡m˧˩˨
chốc	cok͡p˦˥
chối	coj˨˦
chốn	con˨˦
chống	coŋ͡m˨˦
chốp	cop˦˥
chốt	cot˦˥
chồ	co˧˨
chồi	coj˧˨
chồm	com˧˨
chồn	con˧˨
chồng	coŋ͡m˧˨
chổi	coj˧˩˨
chổm	com˧˩˨
chổng	coŋ͡m˧˩˨
chỗ	co˧ˀ˥
chỗi	coj˧ˀ˥
chỗm	com˧ˀ˥
chộ	co˨ˀ˩ʔ
chội	coj˨ˀ˩ʔ
chộn	con˨ˀ˩ʔ
chộp	cop˨ˀ˩
chột	cot˨ˀ˩
chớ	cɤ˨˦
chới	cɤj˨˦
chớm	cɤm˨˦
chớn	cɤn˨˦
chớp	cɤp˦˥
chớt	cɤt˦˥
chờ	cɤ˧˨
chờm	cɤm˧˨
chờn	cɤn˧˨
chở	cɤ˧˩˨
chởm	cɤm˧˩˨
chợ	cɤ˨ˀ˩ʔ
chợn	cɤn˨ˀ˩ʔ
chợp	cɤp˨ˀ˩
chợt	cɤt˨ˀ˩
chục	cuk͡p˨ˀ˩
chụm	cum˨ˀ˩ʔ
chụp	cup˨ˀ˩
chụt	cut˨ˀ˩
chủ	cu˧˩˨
chủa	cuə˧˩˨
chủm	cum˧˩˨
chủn	cun˧˩˨
chủng	cuŋ͡m˧˩˨
chứ	cɯ˨˦
chứa	cɯə˨˦
chức	cɯk˦˥
chứng	cɯŋ˨˦
chứt	cɯt˦˥
chừ	cɯ˧˨
chừa	cɯə˧˨
chừng	cɯŋ˧˨
chửa	cɯə˧˩˨
chửi	cɯj˧˩˨
chửng	cɯŋ˧˩˨
chữ	cɯ˧ˀ˥
chữa	cɯə˧ˀ˥
chững	cɯŋ˧ˀ˥
chực	cɯk˨ˀ˩
chựng	cɯŋ˨ˀ˩ʔ
co	kɔ˧˧
coi	kɔj˧˧
com	kɔm˧˧
con	kɔn˧˧
cong	kɔŋ͡m˧˧
coong	kɔɔŋ͡m˧˧
cot	kɔt˧˧
coóc	kɔɔk͡p˦˥
coọc	kɔɔk͡p˨ˀ˩
cu	ku˧˧
cua	kuə˧˧
cui	kuj˧˧
cum	kum˧˧
cun	kun˧˧
cung	kuŋ͡m˧˧
cuông	kuəŋ˧˧
cuốc	kuək˦˥
cuối	kuəj˨˦
cuốn	kuən˨˦
cuống	kuəŋ˨˦
cuồn	kuən˧˨
cuồng	kuəŋ˧˨
cuỗm	kuəm˧ˀ˥
cuộc	kuək˨ˀ˩
cuội	kuəj˨ˀ˩ʔ
cuộn	kuən˨ˀ˩ʔ
cuộng	kuəŋ˨ˀ˩ʔ
cuờng	kuəŋ˧˨
cy	ki˧˧
cà	ka˧˨
cài	kaj˧˨
càm	kam˧˨
càn	kan˧˨
càng	kaŋ˧˨
cành	kɛŋ˧˨
cào	kaw˧˨
càu	kăw˧˨
cày	kăj˧˨
cá	ka˨˦
các	kak˦˥
cách	kɛk˦˥
cái	kaj˨˦
cám	kam˨˦
cán	kan˨˦
cáng	kaŋ˨˦
cánh	kɛŋ˨˦
cáo	kaw˨˦
cáp	kap˦˥
cát	kat˦˥
cáu	kăw˨˦
cáy	kăj˨˦
câm	kɤ̆m˧˧
cân	kɤ̆n˧˧
câng	kɤ̆ŋ˧˧
câu	kɤ̆w˧˧
cây	kɤ̆j˧˧
cãi	kaj˧ˀ˥
cò	kɔ˧˨
còi	kɔj˧˨
còm	kɔm˧˨
còn	kɔn˧˨
còng	kɔŋ͡m˧˨
có	kɔ˨˦
cóc	kɔk͡p˦˥
cói	kɔj˨˦
cóm	kɔm˨˦
cón	kɔn˨˦
cóng	kɔŋ͡m˨˦
cóp	kɔp˦˥
cót	kɔt˦˥
cô	ko˧˧
côi	koj˧˧
côm	kom˧˧
côn	kon˧˧
công	koŋ͡m˧˧
côống	koŋ͡m˨˦
cõi	kɔj˧ˀ˥
cõm	kɔm˧ˀ˥
cõng	kɔŋ͡m˧ˀ˥
cù	ku˧˨
cùa	kuə˧˨
cùi	kuj˧˨
cùm	kum˧˨
cùn	kun˧˨
cùng	kuŋ͡m˧˨
cú	ku˨˦
cúa	kuə˨˦
cúc	kuk͡p˦˥
cúi	kuj˨˦
cúm	kum˨˦
cún	kun˨˦
cúng	kuŋ͡m˨˦
cúp	kup˦˥
cút	kut˦˥
căm	kăm˧˧
căn	kăn˧˧
căng	kăŋ˧˧
cũ	ku˧ˀ˥
cũi	kuj˧ˀ˥
cũn	kun˧ˀ˥
cũng	kuŋ͡m˧ˀ˥
cơ	kɤ˧˧
cơi	kɤj˧˧
cơm	kɤm˧˧
cơn	kɤn˧˧
cư	kɯ˧˧
cưa	kɯə˧˧
cưng	kɯŋ˧˧
cưu	kɯw˧˧
cương	kɯəŋ˧˧
cước	kɯək˦˥
cưới	kɯəj˨˦
cướp	kɯəp˦˥
cười	kɯəj˧˨
cườm	kɯəm˧˨
cường	kɯəŋ˧˨
cưỡi	kɯəj˧ˀ˥
cưỡng	kɯəŋ˧ˀ˥
cược	kɯək˨ˀ˩
cạ	ka˨ˀ˩ʔ
cạc	kak˨ˀ˩
cạch	kɛk˨ˀ˩
cạm	kam˨ˀ˩ʔ
cạn	kan˨ˀ˩ʔ
cạnh	kɛŋ˨ˀ˩ʔ
cạo	kaw˨ˀ˩ʔ
cạp	kap˨ˀ˩
cạu	kăw˨ˀ˩ʔ
cạy	kăj˨ˀ˩ʔ
cả	ka˧˩˨
cải	kaj˧˩˨
cảm	kam˧˩˨
cản	kan˧˩˨
cảng	kaŋ˧˩˨
cảnh	kɛŋ˧˩˨
cảo	kaw˧˩˨
cảu	kăw˧˩˨
cảy	kăj˧˩˨
cấc	kɤ̆k˦˥
cấm	kɤ̆m˨˦
cấn	kɤ̆n˨˦
cấp	kɤ̆p˦˥
cất	kɤ̆t˦˥
cấu	kɤ̆w˨˦
cấy	kɤ̆j˨˦
cầm	kɤ̆m˧˨
cần	kɤ̆n˧˨
cầu	kɤ̆w˧˨
cầy	kɤ̆j˧˨
cẩm	kɤ̆m˧˩˨
cẩn	kɤ̆n˧˩˨
cẩu	kɤ̆w˧˩˨
cẩy	kɤ̆j˧˩˨
cẫm	kɤ̆m˧ˀ˥
cẫn	kɤ̆n˧ˀ˥
cẫng	kɤ̆ŋ˧ˀ˥
cậm	kɤ̆m˨ˀ˩ʔ
cận	kɤ̆n˨ˀ˩ʔ
cập	kɤ̆p˨ˀ˩
cật	kɤ̆t˨ˀ˩
cậu	kɤ̆w˨ˀ˩ʔ
cậy	kɤ̆j˨ˀ˩ʔ
cắc	kăk˦˥
cắm	kăm˨˦
cắn	kăn˨˦
cắng	kăŋ˨˦
cắp	kăp˦˥
cắt	kăt˦˥
cằm	kăm˧˨
cằn	kăn˧˨
cẳn	kăn˧˩˨
cẳng	kăŋ˧˩˨
cẵng	kăŋ˧ˀ˥
cặc	kăk˨ˀ˩
cặm	kăm˨ˀ˩ʔ
cặn	kăn˨ˀ˩ʔ
cặp	kăp˨ˀ˩
cặt	kăt˨ˀ˩
cọ	kɔ˨ˀ˩ʔ
cọc	kɔk͡p˨ˀ˩
cọi	kɔj˨ˀ˩ʔ
cọm	kɔm˨ˀ˩ʔ
cọn	kɔn˨ˀ˩ʔ
cọng	kɔŋ͡m˨ˀ˩ʔ
cọp	kɔp˨ˀ˩
cọt	kɔt˨ˀ˩
cỏ	kɔ˧˩˨
cỏi	kɔj˧˩˨
cỏm	kɔm˧˩˨
cỏn	kɔn˧˩˨
cỏng	kɔŋ͡m˧˩˨
cố	ko˨˦
cốc	kok͡p˦˥
cối	koj˨˦
cốm	kom˨˦
cốn	kon˨˦
cống	koŋ͡m˨˦
cốp	kop˦˥
cốt	kot˦˥
cồ	ko˧˨
cồm	kom˧˨
cồn	kon˧˨
cồng	koŋ͡m˧˨
cổ	ko˧˩˨
cổi	koj˧˩˨
cổn	kon˧˩˨
cổng	koŋ͡m˧˩˨
cỗ	ko˧ˀ˥
cỗi	koj˧ˀ˥
cộ	ko˨ˀ˩ʔ
cộc	kok͡p˨ˀ˩
cội	koj˨ˀ˩ʔ
cộm	kom˨ˀ˩ʔ
cộn	kon˨ˀ˩ʔ
cộng	koŋ͡m˨ˀ˩ʔ
cộp	kop˨ˀ˩
cột	kot˨ˀ˩
cớ	kɤ˨˦
cớm	kɤm˨˦
cớn	kɤn˨˦
cớt	kɤt˦˥
cờ	kɤ˧˨
cời	kɤj˧˨
cờn	kɤn˧˨
cởi	kɤj˧˩˨
cỡ	kɤ˧ˀ˥
cỡi	kɤj˧ˀ˥
cỡm	kɤm˧ˀ˥
cỡn	kɤn˧ˀ˥
cợm	kɤm˨ˀ˩ʔ
cợn	kɤn˨ˀ˩ʔ
cợp	kɤp˨ˀ˩
cợt	kɤt˨ˀ˩
cụ	ku˨ˀ˩ʔ
cục	kuk͡p˨ˀ˩
cụi	kuj˨ˀ˩ʔ
cụm	kum˨ˀ˩ʔ
cụng	kuŋ͡m˨ˀ˩ʔ
cụp	kup˨ˀ˩
cụt	kut˨ˀ˩
củ	ku˧˩˨
của	kuə˧˩˨
củi	kuj˧˩˨
củm	kum˧˩˨
củn	kun˧˩˨
củng	kuŋ͡m˧˩˨
cứ	kɯ˨˦
cứa	kɯə˨˦
cức	kɯk˦˥
cứng	kɯŋ˨˦
cứt	kɯt˦˥
cứu	kɯw˨˦
cừ	kɯ˧˨
cừu	kɯw˧˨
cử	kɯ˧˩˨
cửa	kɯə˧˩˨
cửi	kɯj˧˩˨
cửng	kɯŋ˧˩˨
cửu	kɯw˧˩˨
cữ	kɯ˧ˀ˥
cữu	kɯw˧ˀ˥
cự	kɯ˨ˀ˩ʔ
cựa	kɯə˨ˀ˩ʔ
cực	kɯk˨ˀ˩
cựu	kɯw˨ˀ˩ʔ
da	za˧˧
dai	zaj˧˧
dam	zam˧˧
dan	zan˧˧
dang	zaŋ˧˧
danh	zɛŋ˧˧
dao	zaw˧˧
day	zăj˧˧
de	zɛ˧˧
den	zɛn˧˧
deo	zeo˧˧
di	zi˧˧
dim	zim˧˧
din	zin˧˧
dinh	ziŋ˧˧
diu	ziw˧˧
diêm	ziəm˧˧
diên	ziən˧˧
diêu	ziəw˧˧
diếc	ziək˦˥
diếp	ziəp˦˥
diết	ziət˦˥
diếu	ziəw˨˦
diềm	ziəm˧˨
diềng	ziəŋ˧˨
diều	ziəw˧˨
diễm	ziəm˧ˀ˥
diễn	ziən˧ˀ˥
diễu	ziəw˧ˀ˥
diệc	ziək˨ˀ˩
diệm	ziəm˨ˀ˩ʔ
diện	ziən˨ˀ˩ʔ
diệp	ziəp˨ˀ˩
diệt	ziət˨ˀ˩
diệu	ziəw˨ˀ˩ʔ
do	zɔ˧˧
doa	zwa˧˧
doan	zwan˧˧
doanh	zwɛŋ˧˧
doi	zɔj˧˧
dom	zɔm˧˧
don	zɔn˧˧
dong	zɔŋ͡m˧˧
doàng	zwaŋ˧˨
doành	zwɛŋ˧˨
doá	zwa˨˦
doãi	zwaj˧ˀ˥
doãn	zwan˧ˀ˥
doãng	zwaŋ˧ˀ˥
doạ	zwa˨ˀ˩ʔ
doạng	zwaŋ˨ˀ˩ʔ
du	zu˧˧
dua	zuə˧˧
dun	zun˧˧
dung	zuŋ͡m˧˧
duy	zwi˧˧
duyên	zwiən˧˧
duyệt	zwiət˨ˀ˩
duôi	zuəj˧˧
duật	zwɤ̆t˨ˀ˩
duềnh	zweŋ˧˨
duệ	zwe˨ˀ˩ʔ
duốc	zuək˦˥
duối	zuəj˨˦
duồn	zuən˧˨
duỗi	zuəj˧ˀ˥
duộc	zuək˨ˀ˩
dy	zi˧˧
dyn	zin˧˧
dà	za˧˨
dài	zaj˧˨
dàm	zam˧˨
dàn	zan˧˨
dàng	zaŋ˧˨
dành	zɛŋ˧˨
dào	zaw˧˨
dàu	zăw˧˨
dày	zăj˧˨
dá	za˨˦
dác	zak˦˥
dách	zɛk˦˥
dái	zaj˨˦
dám	zam˨˦
dán	zan˨˦
dáng	zaŋ˨˦
dáo	zaw˨˦
dát	zat˦˥
dáu	zăw˨˦
dáy	zăj˨˦
dâm	zɤ̆m˧˧
dân	zɤ̆n˧˧
dâng	zɤ̆ŋ˧˧
dâu	zɤ̆w˧˧
dây	zɤ̆j˧˧
dã	za˧ˀ˥
dãi	zaj˧ˀ˥
dãn	zan˧ˀ˥
dãy	zăj˧ˀ˥
dè	zɛ˧˨
dèn	zɛn˧˨
dé	zɛ˨˦
dém	zɛm˨˦
déo	zeo˨˦
dép	zɛp˦˥
dét	zɛt˦˥
dê	ze˧˧
dên	zen˧˧
dênh	zeŋ˧˧
dì	zi˧˨
dìa	ziə˧˨
dìm	zim˧˨
dìu	ziw˧˨
dí	zi˨˦
dích	zik˦˥
dím	zim˨˦
dính	ziŋ˨˦
díp	zip˦˥
dít	zit˦˥
díu	ziw˨˦
dò	zɔ˧˨
dòi	zɔj˧˨
dòm	zɔm˧˨
dòng	zɔŋ͡m˧˨
dó	zɔ˨˦
dóa	zwa˨˦
dóc	zɔk͡p˦˥
dói	zɔj˨˦
dóm	zɔm˨˦
dón	zɔn˨˦
dóng	zɔŋ͡m˨˦
dót	zɔt˦˥
dô	zo˧˧
dôi	zoj˧˧
dôn	zon˧˧
dông	zoŋ͡m˧˧
dõi	zɔj˧ˀ˥
dõng	zɔŋ͡m˧ˀ˥
dù	zu˧˨
dùa	zuə˧˨
dùi	zuj˧˨
dùn	zun˧˨
dùng	zuŋ͡m˧˨
dúa	zuə˨˦
dúi	zuj˨˦
dúm	zum˨˦
dún	zun˨˦
dúng	zuŋ͡m˨˦
dút	zut˦˥
dýn	zin˨˦
dăm	zăm˧˧
dăn	zăn˧˧
dăng	zăŋ˧˧
dĩ	zi˧ˀ˥
dĩa	ziə˧ˀ˥
dĩn	zin˧ˀ˥
dĩnh	ziŋ˧ˀ˥
dũ	zu˧ˀ˥
dũa	zuə˧ˀ˥
dũi	zuj˧ˀ˥
dũng	zuŋ͡m˧ˀ˥
dơ	zɤ˧˧
dơi	zɤj˧˧
dơn	zɤn˧˧
dư	zɯ˧˧
dưa	zɯə˧˧
dưng	zɯŋ˧˧
dương	zɯəŋ˧˧
dưới	zɯəj˨˦
dướn	zɯən˨˦
dướng	zɯəŋ˨˦
dường	zɯəŋ˧˨
dưỡng	zɯəŋ˧ˀ˥
dược	zɯək˨ˀ˩
dượi	zɯəj˨ˀ˩ʔ
dượng	zɯəŋ˨ˀ˩ʔ
dượt	zɯət˨ˀ˩
dạ	za˨ˀ˩ʔ
dạc	zak˨ˀ˩
dại	zaj˨ˀ˩ʔ
dạm	zam˨ˀ˩ʔ
dạn	zan˨ˀ˩ʔ
dạng	zaŋ˨ˀ˩ʔ
dạo	zaw˨ˀ˩ʔ
dạt	zat˨ˀ˩
dạy	zăj˨ˀ˩ʔ
dả	za˧˩˨
dải	zaj˧˩˨
dảnh	zɛŋ˧˩˨
dảy	zăj˧˩˨
dấm	zɤ̆m˨˦
dấn	zɤ̆n˨˦
dấp	zɤ̆p˦˥
dấu	zɤ̆w˨˦
dấy	zɤ̆j˨˦
dầm	zɤ̆m˧˨
dần	zɤ̆n˧˨
dầu	zɤ̆w˧˨
dầy	zɤ̆j˧˨
dẩm	zɤ̆m˧˩˨
dẩn	zɤ̆n˧˩˨
dẩu	zɤ̆w˧˩˨
dẩy	zɤ̆j˧˩˨
dẫm	zɤ̆m˧ˀ˥
dẫn	zɤ̆n˧ˀ˥
dẫu	zɤ̆w˧ˀ˥
dẫy	zɤ̆j˧ˀ˥
dậm	zɤ̆m˨ˀ˩ʔ
dận	zɤ̆n˨ˀ˩ʔ
dập	zɤ̆p˨ˀ˩
dật	zɤ̆t˨ˀ˩
dậu	zɤ̆w˨ˀ˩ʔ
dậy	zɤ̆j˨ˀ˩ʔ
dắc	zăk˦˥
dắm	zăm˨˦
dắng	zăŋ˨˦
dắt	zăt˦˥
dằm	zăm˧˨
dằn	zăn˧˨
dằng	zăŋ˧˨
dẳn	zăn˧˩˨
dẳng	zăŋ˧˩˨
dặc	zăk˨ˀ˩
dặm	zăm˨ˀ˩ʔ
dặn	zăn˨ˀ˩ʔ
dặng	zăŋ˨ˀ˩ʔ
dặt	zăt˨ˀ˩
dẹm	zɛm˨ˀ˩ʔ
dẹo	zeo˨ˀ˩ʔ
dẹp	zɛp˨ˀ˩
dẹt	zɛt˨ˀ˩
dẻ	zɛ˧˩˨
dẻo	zeo˧˩˨
dẽ	zɛ˧ˀ˥
dế	ze˨˦
dếch	zek˦˥
dết	zet˦˥
dề	ze˧˨
dền	zen˧˨
dềnh	zeŋ˧˨
dể	ze˧˩˨
dễ	ze˧ˀ˥
dệ	ze˨ˀ˩ʔ
dệch	zek˨ˀ˩
dện	zen˨ˀ˩ʔ
dệnh	zeŋ˨ˀ˩ʔ
dệt	zet˨ˀ˩
dệu	zɛu˨ˀ˩ʔ
dỉ	zi˧˩˨
dị	zi˨ˀ˩ʔ
dịch	zik˨ˀ˩
dịp	zip˨ˀ˩
dịt	zit˨ˀ˩
dịu	ziw˨ˀ˩ʔ
dọ	zɔ˨ˀ˩ʔ
dọa	zwa˨ˀ˩ʔ
dọc	zɔk͡p˨ˀ˩
dọi	zɔj˨ˀ˩ʔ
dọn	zɔn˨ˀ˩ʔ
dọng	zɔŋ͡m˨ˀ˩ʔ
dọp	zɔp˨ˀ˩
dỏ	zɔ˧˩˨
dỏm	zɔm˧˩˨
dỏng	zɔŋ͡m˧˩˨
dốc	zok͡p˦˥
dối	zoj˨˦
dống	zoŋ͡m˨˦
dốp	zop˦˥
dốt	zot˦˥
dồ	zo˧˨
dồi	zoj˧˨
dồn	zon˧˨
dồng	zoŋ͡m˧˨
dổi	zoj˧˩˨
dổm	zom˧˩˨
dỗ	zo˧ˀ˥
dỗi	zoj˧ˀ˥
dộc	zok͡p˨ˀ˩
dội	zoj˨ˀ˩ʔ
dộng	zoŋ͡m˨ˀ˩ʔ
dộp	zop˨ˀ˩
dột	zot˨ˀ˩
dớ	zɤ˨˦
dớn	zɤn˨˦
dớp	zɤp˦˥
dờ	zɤ˧˨
dời	zɤj˧˨
dờn	zɤn˧˨
dở	zɤ˧˩˨
dởm	zɤm˧˩˨
dỡ	zɤ˧ˀ˥
dợ	zɤ˨ˀ˩ʔ
dợm	zɤm˨ˀ˩ʔ
dợn	zɤn˨ˀ˩ʔ
dụ	zu˨ˀ˩ʔ
dục	zuk͡p˨ˀ˩
dụi	zuj˨ˀ˩ʔ
dụm	zum˨ˀ˩ʔ
dụng	zuŋ͡m˨ˀ˩ʔ
dụt	zut˨ˀ˩
dủi	zuj˧˩˨
dứ	zɯ˨˦
dứa	zɯə˨˦
dức	zɯk˦˥
dứng	zɯŋ˨˦
dứt	zɯt˦˥
dừ	zɯ˧˨
dừa	zɯə˧˨
dừng	zɯŋ˧˨
dử	zɯ˧˩˨
dửng	zɯŋ˧˩˨
dữ	zɯ˧ˀ˥
dự	zɯ˨ˀ˩ʔ
dựa	zɯə˨ˀ˩ʔ
dực	zɯk˨ˀ˩
dựng	zɯŋ˨ˀ˩ʔ
dựt	zɯt˨ˀ˩
e	ɛ˧˧
em	ɛm˧˧
en	ɛn˧˧
eng	ɛŋ˧˧
eo	eo˧˧
ga	ɣa˧˧
gai	ɣaj˧˧
gam	ɣam˧˧
gan	ɣan˧˧
gang	ɣaŋ˧˧
ganh	ɣɛŋ˧˧
gao	ɣaw˧˧
gau	ɣăw˧˧
gay	ɣăj˧˧
ge	ɣɛ˧˧
gen	ɣɛn˧˧
ghe	ɣɛ˧˧
ghen	ɣɛn˧˧
ghi	ɣi˧˧
ghim	ɣim˧˧
ghin	ɣin˧˧
ghiếc	ɣiək˦˥
ghiền	ɣiən˧˨
ghè	ɣɛ˧˨
ghèn	ɣɛn˧˨
ghé	ɣɛ˨˦
ghém	ɣɛm˨˦
ghép	ɣɛp˦˥
ghét	ɣɛt˦˥
ghê	ɣe˧˧
ghì	ɣi˧˨
ghìm	ɣim˧˨
ghình	ɣiŋ˧˨
ghín	ɣin˨˦
ghính	ɣiŋ˨˦
ghít	ɣit˦˥
ghẹ	ɣɛ˨ˀ˩ʔ
ghẹn	ɣɛn˨ˀ˩ʔ
ghẹo	ɣeo˨ˀ˩ʔ
ghẻ	ɣɛ˧˩˨
ghẽ	ɣɛ˧ˀ˥
ghế	ɣe˨˦
ghếch	ɣek˦˥
ghề	ɣe˧˨
ghềnh	ɣeŋ˧˨
ghểnh	ɣeŋ˧˩˨
ghễnh	ɣeŋ˧ˀ˥
ghệch	ɣek˨ˀ˩
ghệt	ɣet˨ˀ˩
ghịt	ɣit˨ˀ˩
gi	zi˧˧
gia	za˧˧
giai	zaj˧˧
giam	zam˧˧
gian	zan˧˧
giang	zaŋ˧˧
gianh	zɛŋ˧˧
giao	zaw˧˧
giau	zăw˧˧
gic	zik˧˧
gie	zɛ˧˧
gien	zɛn˧˧
gieo	zeo˧˧
gin	zin˧˧
gio	zɔ˧˧
gioi	zɔj˧˧
gion	zɔn˧˧
giong	zɔŋ͡m˧˧
gioong	zɔɔŋ͡m˧˧
gioàng	zwaŋ˧˨
gioòng	zɔɔŋ͡m˧˨
gioăng	zwăŋ˧˧
gip	zip˧˧
giu	zu˧˧
giua	zuə˧˧
giun	zun˧˧
giuộc	zuək˨ˀ˩
già	za˧˨
giàm	zam˧˨
giàn	zan˧˨
giàng	zaŋ˧˨
giành	zɛŋ˧˨
giào	zaw˧˨
giàu	zăw˧˨
giày	zăj˧˨
giá	za˨˦
giác	zak˦˥
giám	zam˨˦
gián	zan˨˦
giáng	zaŋ˨˦
giáo	zaw˨˦
giáp	zap˦˥
giát	zat˦˥
giáy	zăj˨˦
giâm	zɤ̆m˧˧
giâu	zɤ̆w˧˧
giây	zɤ̆j˧˧
giã	za˧ˀ˥
giãi	zaj˧ˀ˥
giãn	zan˧ˀ˥
giãy	zăj˧ˀ˥
gièm	zɛm˧˨
gié	zɛ˨˦
giéo	zeo˨˦
giê	ze˧˧
giêng	zeŋ˧˧
giò	zɔ˧˨
giòi	zɔj˧˨
giòn	zɔn˧˨
gió	zɔ˨˦
gióc	zɔk͡p˦˥
giói	zɔj˨˦
gión	zɔn˨˦
gióng	zɔŋ͡m˨˦
giô	zo˧˧
giôn	zon˧˧
giông	zoŋ͡m˧˧
giùi	zuj˧˨
giùm	zum˧˨
giú	zu˨˦
giúi	zuj˨˦
giúp	zup˦˥
giăm	zăm˧˧
giăng	zăŋ˧˧
giũ	zu˧ˀ˥
giũa	zuə˧ˀ˥
giơ	zɤ˧˧
giương	zɯəŋ˧˧
giướng	zɯəŋ˨˦
giường	zɯəŋ˧˨
giượng	zɯəŋ˨ˀ˩ʔ
giạ	za˨ˀ˩ʔ
giạc	zak˨ˀ˩
giại	zaj˨ˀ˩ʔ
giạm	zam˨ˀ˩ʔ
giạng	zaŋ˨ˀ˩ʔ
giạp	zap˨ˀ˩
giạt	zat˨ˀ˩
giả	za˧˩˨
giải	zaj˧˩˨
giảm	zam˧˩˨
giản	zan˧˩˨
giảng	zaŋ˧˩˨
giảnh	zɛŋ˧˩˨
giảo	zaw˧˩˨
giảu	zăw˧˩˨
giấc	zɤ̆k˦˥
giấm	zɤ̆m˨˦
giấn	zɤ̆n˨˦
giấp	zɤ̆p˦˥
giấu	zɤ̆w˨˦
giấy	zɤ̆j˨˦
giầm	zɤ̆m˧˨
giần	zɤ̆n˧˨
giầu	zɤ̆w˧˨
giầy	zɤ̆j˧˨
giẫm	zɤ̆m˧ˀ˥
giẫy	zɤ̆j˧ˀ˥
giậm	zɤ̆m˨ˀ˩ʔ
giận	zɤ̆n˨ˀ˩ʔ
giập	zɤ̆p˨ˀ˩
giật	zɤ̆t˨ˀ˩
giậu	zɤ̆w˨ˀ˩ʔ
giắc	zăk˦˥
giắm	zăm˨˦
giắn	zăn˨˦
giắng	zăŋ˨˦
giắt	zăt˦˥
giằm	zăm˧˨
giằn	zăn˧˨
giằng	zăŋ˧˨
giẳn	zăn˧˩˨
giẵm	zăm˧ˀ˥
giặc	zăk˨ˀ˩
giặm	zăm˨ˀ˩ʔ
giặn	zăn˨ˀ˩ʔ
giặt	zăt˨ˀ˩
giẹo	zeo˨ˀ˩ʔ
giẹp	zɛp˨ˀ˩
giẻ	zɛ˧˩˨
giếc	zek˦˥
giếm	zem˨˦
giếng	zeŋ˨˦
giết	zet˦˥
giề	ze˧˨
giền	zen˧˨
giềng	zeŋ˧˨
giễu	zɛu˧ˀ˥
giọ	zɔ˨ˀ˩ʔ
giọc	zɔk͡p˨ˀ˩
giọi	zɔj˨ˀ˩ʔ
giọng	zɔŋ͡m˨ˀ˩ʔ
giọt	zɔt˨ˀ˩
giỏ	zɔ˧˩˨
giỏi	zɔj˧˩˨
giỏn	zɔn˧˩˨
giỏng	zɔŋ͡m˧˩˨
giốc	zok͡p˦˥
giối	zoj˨˦
giống	zoŋ͡m˨˦
giốt	zot˦˥
giồ	zo˧˨
giồi	zoj˧˨
giồng	zoŋ͡m˧˨
giổi	zoj˧˩˨
giỗ	zo˧ˀ˥
giỗi	zoj˧ˀ˥
giộ	zo˨ˀ˩ʔ
giội	zoj˨ˀ˩ʔ
giộp	zop˨ˀ˩
giới	zɤj˨˦
giờ	zɤ˧˨
giời	zɤj˧˨
giờn	zɤn˧˨
giở	zɤ˧˩˨
giỡn	zɤn˧ˀ˥
giụa	zuə˨ˀ˩ʔ
giục	zuk͡p˨ˀ˩
giụi	zuj˨ˀ˩ʔ
giủi	zuj˧˩˨
giừ	zɯ˧˨
giữ	zɯ˧ˀ˥
giữa	zɯə˧ˀ˥
giựt	zɯt˨ˀ˩
go	ɣɔ˧˧
gom	ɣɔm˧˧
gon	ɣɔn˧˧
goong	ɣɔɔŋ͡m˧˧
goá	ɣwa˨˦
goòng	ɣɔɔŋ͡m˧˨
gu	ɣu˧˧
guy	ɣwi˧˧
guốc	ɣuək˦˥
guồi	ɣuəj˧˨
guồng	ɣuəŋ˧˨
guổng	ɣuəŋ˧˩˨
guộc	ɣuək˨ˀ˩
guộn	ɣuən˨ˀ˩ʔ
guột	ɣuət˨ˀ˩
gà	ɣa˧˨
gài	ɣaj˧˨
gàn	ɣan˧˨
gàng	ɣaŋ˧˨
gành	ɣɛŋ˧˨
gào	ɣaw˧˨
gàu	ɣăw˧˨
gày	ɣăj˧˨
gá	ɣa˨˦
gác	ɣak˦˥
gách	ɣɛk˦˥
gái	ɣaj˨˦
gán	ɣan˨˦
gánh	ɣɛŋ˨˦
gáo	ɣaw˨˦
gáp	ɣap˦˥
gát	ɣat˦˥
gáu	ɣăw˨˦
gáy	ɣăj˨˦
gâm	ɣɤ̆m˧˧
gân	ɣɤ̆n˧˧
gâu	ɣɤ̆w˧˧
gây	ɣɤ̆j˧˧
gã	ɣa˧ˀ˥
gãi	ɣaj˧ˀ˥
gãy	ɣăj˧ˀ˥
gêm	ɣem˧˧
gì	zi˧˨
gìm	zim˧˨
gìn	zin˧˨
gí	zi˨˦
gích	zik˦˥
gíp	zip˦˥
gò	ɣɔ˧˨
gòn	ɣɔn˧˨
góa	ɣwa˨˦
góc	ɣɔk͡p˦˥
gói	ɣɔj˨˦
góp	ɣɔp˦˥
gót	ɣɔt˦˥
gô	ɣo˧˧
gôm	ɣom˧˧
gôn	ɣon˧˧
gông	ɣoŋ͡m˧˧
gõ	ɣɔ˧ˀ˥
gù	ɣu˧˨
gùa	ɣuə˧˨
gùi	ɣuj˧˨
gùn	ɣun˧˨
gùng	ɣuŋ͡m˧˨
gúa	ɣuə˨˦
gút	ɣut˦˥
găm	ɣăm˧˧
găn	ɣăn˧˧
găng	ɣăŋ˧˧
gũi	ɣuj˧ˀ˥
gơ	ɣɤ˧˧
gơn	ɣɤn˧˧
gươm	ɣɯəm˧˧
gương	ɣɯəŋ˧˧
gườm	ɣɯəm˧˨
gường	ɣɯəŋ˧˨
gưởi	ɣɯəj˧˩˨
gưỡng	ɣɯəŋ˧ˀ˥
gượm	ɣɯəm˨ˀ˩ʔ
gượng	ɣɯəŋ˨ˀ˩ʔ
gạ	ɣa˨ˀ˩ʔ
gạc	ɣak˨ˀ˩
gạch	ɣɛk˨ˀ˩
gại	ɣaj˨ˀ˩ʔ
gạn	ɣan˨ˀ˩ʔ
gạnh	ɣɛŋ˨ˀ˩ʔ
gạo	ɣaw˨ˀ˩ʔ
gạt	ɣat˨ˀ˩
gạy	ɣăj˨ˀ˩ʔ
gả	ɣa˧˩˨
gảnh	ɣɛŋ˧˩˨
gảy	ɣăj˧˩˨
gấc	ɣɤ̆k˦˥
gấm	ɣɤ̆m˨˦
gấp	ɣɤ̆p˦˥
gấu	ɣɤ̆w˨˦
gấy	ɣɤ̆j˨˦
gầm	ɣɤ̆m˧˨
gần	ɣɤ̆n˧˨
gầu	ɣɤ̆w˧˨
gầy	ɣɤ̆j˧˨
gẩm	ɣɤ̆m˧˩˨
gẩy	ɣɤ̆j˧˩˨
gẫm	ɣɤ̆m˧ˀ˥
gẫu	ɣɤ̆w˧ˀ˥
gẫy	ɣɤ̆j˧ˀ˥
gậm	ɣɤ̆m˨ˀ˩ʔ
gận	ɣɤ̆n˨ˀ˩ʔ
gập	ɣɤ̆p˨ˀ˩
gật	ɣɤ̆t˨ˀ˩
gậy	ɣɤ̆j˨ˀ˩ʔ
gắm	ɣăm˨˦
gắn	ɣăn˨˦
gắng	ɣăŋ˨˦
gắp	ɣăp˦˥
gắt	ɣăt˦˥
gằm	ɣăm˧˨
gằn	ɣăn˧˨
gẵng	ɣăŋ˧ˀ˥
gặc	ɣăk˨ˀ˩
gặm	ɣăm˨ˀ˩ʔ
gặn	ɣăn˨ˀ˩ʔ
gặng	ɣăŋ˨ˀ˩ʔ
gặp	ɣăp˨ˀ˩
gặt	ɣăt˨ˀ˩
gỉ	zi˧˩˨
gịa	ziə˨ˀ˩ʔ
gọ	ɣɔ˨ˀ˩ʔ
gọc	ɣɔk͡p˨ˀ˩
gọi	ɣɔj˨ˀ˩ʔ
gọn	ɣɔn˨ˀ˩ʔ
gọng	ɣɔŋ͡m˨ˀ˩ʔ
gọt	ɣɔt˨ˀ˩
gỏi	ɣɔj˧˩˨
gỏng	ɣɔŋ͡m˧˩˨
gốc	ɣok͡p˦˥
gối	ɣoj˨˦
gốm	ɣom˨˦
gồ	ɣo˧˨
gồi	ɣoj˧˨
gồm	ɣom˧˨
gồng	ɣoŋ͡m˧˨
gổ	ɣo˧˩˨
gỗ	ɣo˧ˀ˥
gộ	ɣo˨ˀ˩ʔ
gộc	ɣok͡p˨ˀ˩
gội	ɣoj˨ˀ˩ʔ
gộp	ɣop˨ˀ˩
gột	ɣot˨ˀ˩
gớm	ɣɤm˨˦
gờ	ɣɤ˧˨
gờm	ɣɤm˧˨
gờn	ɣɤn˧˨
gở	ɣɤ˧˩˨
gởi	ɣɤj˧˩˨
gỡ	ɣɤ˧ˀ˥
gợi	ɣɤj˨ˀ˩ʔ
gợn	ɣɤn˨ˀ˩ʔ
gợt	ɣɤt˨ˀ˩
gụ	ɣu˨ˀ˩ʔ
gục	ɣuk͡p˨ˀ˩
gụi	ɣuj˨ˀ˩ʔ
gụt	ɣut˨ˀ˩
gủa	ɣuə˧˩˨
gứng	ɣɯŋ˨˦
gừ	ɣɯ˧˨
gừng	ɣɯŋ˧˨
gửi	ɣɯj˧˩˨
ha	ha˧˧
hai	haj˧˧
ham	ham˧˧
han	han˧˧
hang	haŋ˧˧
hanh	hɛŋ˧˧
hao	haw˧˧
hau	hăw˧˧
hay	hăj˧˧
he	hɛ˧˧
hec	hɛk˧˧
hem	hɛm˧˧
hen	hɛn˧˧
heo	heo˧˧
hi	hi˧˧
hia	hiə˧˧
him	him˧˧
hin	hin˧˧
hinh	hiŋ˧˧
hiu	hiw˧˧
hiên	hiən˧˧
hiêng	hiəŋ˧˧
hiếc	hiək˦˥
hiếm	hiəm˨˦
hiến	hiən˨˦
hiếng	hiəŋ˨˦
hiếp	hiəp˦˥
hiếu	hiəw˨˦
hiềm	hiəm˧˨
hiền	hiən˧˨
hiểm	hiəm˧˩˨
hiển	hiən˧˩˨
hiểu	hiəw˧˩˨
hiện	hiən˨ˀ˩ʔ
hiệp	hiəp˨ˀ˩
hiệt	hiət˨ˀ˩
hiệu	hiəw˨ˀ˩ʔ
ho	hɔ˧˧
hoa	hwa˧˧
hoai	hwaj˧˧
hoan	hwan˧˧
hoang	hwaŋ˧˧
hoay	hwăj˧˧
hoe	hwe˧˧
hoen	hwen˧˧
hoi	hɔj˧˧
hom	hɔm˧˧
hon	hɔn˧˧
hong	hɔŋ͡m˧˧
hoà	hwa˧˨
hoài	hwaj˧˨
hoàn	hwan˧˨
hoàng	hwaŋ˧˨
hoành	hwɛŋ˧˨
hoá	hwa˨˦
hoác	hwak˦˥
hoán	hwan˨˦
hoáng	hwaŋ˨˦
hoánh	hwɛŋ˨˦
hoáy	hwăj˨˦
hoãn	hwan˧ˀ˥
hoãng	hwaŋ˧ˀ˥
hoè	hwe˧˨
hoét	hwet˦˥
hoóc	hɔɔk͡p˦˥
hoăm	hwăm˧˧
hoăng	hwăŋ˧˧
hoạ	hwa˨ˀ˩ʔ
hoạch	hwɛk˨ˀ˩
hoại	hwaj˨ˀ˩ʔ
hoạn	hwan˨ˀ˩ʔ
hoạnh	hwɛŋ˨ˀ˩ʔ
hoạt	hwat˨ˀ˩
hoả	hwa˧˩˨
hoải	hwaj˧˩˨
hoảng	hwaŋ˧˩˨
hoảnh	hwɛŋ˧˩˨
hoắc	hwăk˦˥
hoắm	hwăm˨˦
hoắt	hwăt˦˥
hoằn	hwăn˧˨
hoẳn	hwăn˧˩˨
hoẵng	hwăŋ˧ˀ˥
hoặc	hwăk˨ˀ˩
hoặn	hwăn˨ˀ˩ʔ
hoẹ	hwe˨ˀ˩ʔ
hoẹt	hwet˨ˀ˩
hoẻn	hwen˧˩˨
hu	hu˧˧
hua	huə˧˧
hui	huj˧˧
hum	hum˧˧
hun	hun˧˧
hung	huŋ͡m˧˧
huy	hwi˧˧
huynh	hwiŋ˧˧
huyên	hwiən˧˧
huyết	hwiət˦˥
huyền	hwiən˧˨
huyễn	hwiən˧ˀ˥
huyện	hwiən˨ˀ˩ʔ
huyệt	hwiət˨ˀ˩
huân	hwɤ̆n˧˧
huê	hwe˧˧
huênh	hweŋ˧˧
huý	hwi˨˦
huých	hwik˦˥
huýt	hwit˦˥
huơ	huə˧˧
huấn	hwɤ̆n˨˦
huầy	hwɤ̆j˧˨
huế	hwe˨˦
huếch	hwek˦˥
huề	hwe˧˨
huệ	hwe˨ˀ˩ʔ
huống	huəŋ˨˦
huốt	huət˦˥
huỳnh	hwiŋ˧˨
huỵch	hwik˨ˀ˩
huỷ	hwi˧˩˨
hy	hi˧˧
hà	ha˧˨
hài	haj˧˨
hàm	ham˧˨
hàn	han˧˨
hàng	haŋ˧˨
hành	hɛŋ˧˨
hào	haw˧˨
hàu	hăw˧˨
há	ha˨˦
hác	hak˦˥
hách	hɛk˦˥
hái	haj˨˦
hám	ham˨˦
hán	han˨˦
háng	haŋ˨˦
hánh	hɛŋ˨˦
háo	haw˨˦
háp	hap˦˥
hát	hat˦˥
háu	hăw˨˦
háy	hăj˨˦
hâm	hɤ̆m˧˧
hân	hɤ̆n˧˧
hâu	hɤ̆w˧˧
hây	hɤ̆j˧˧
hãi	haj˧ˀ˥
hãm	ham˧ˀ˥
hãn	han˧ˀ˥
hãng	haŋ˧ˀ˥
hãnh	hɛŋ˧ˀ˥
hão	haw˧ˀ˥
hãy	hăj˧ˀ˥
hè	hɛ˧˨
hèm	hɛm˧˨
hèn	hɛn˧˨
hèo	heo˧˨
hé	hɛ˨˦
héc	hɛk˦˥
hén	hɛn˨˦
héo	heo˨˦
hét	hɛt˦˥
hê	he˧˧
hên	hen˧˧
hênh	heŋ˧˧
hì	hi˧˨
hình	hiŋ˧˨
hí	hi˨˦
hích	hik˦˥
híp	hip˦˥
hít	hit˦˥
hò	hɔ˧˨
hòa	hwa˧˨
hòe	hwe˧˨
hòi	hɔj˧˨
hòm	hɔm˧˨
hòn	hɔn˧˨
hòng	hɔŋ͡m˧˨
hó	hɔ˨˦
hóa	hwa˨˦
hóc	hɔk͡p˦˥
hói	hɔj˨˦
hóm	hɔm˨˦
hón	hɔn˨˦
hóng	hɔŋ͡m˨˦
hóp	hɔp˦˥
hót	hɔt˦˥
hô	ho˧˧
hôi	hoj˧˧
hôm	hom˧˧
hôn	hon˧˧
hông	hoŋ͡m˧˧
hõm	hɔm˧ˀ˥
hù	hu˧˨
hùa	huə˧˨
hùi	huj˧˨
hùm	hum˧˨
hùn	hun˧˨
hùng	huŋ͡m˧˨
hú	hu˨˦
húc	huk͡p˦˥
húi	huj˨˦
húm	hum˨˦
húng	huŋ͡m˨˦
húp	hup˦˥
hút	hut˦˥
húy	hwi˨˦
hý	hi˨˦
hăm	hăm˧˧
hăng	hăŋ˧˧
hĩ	hi˧ˀ˥
hĩm	him˧ˀ˥
hĩnh	hiŋ˧ˀ˥
hũ	hu˧ˀ˥
hũm	hum˧ˀ˥
hơ	hɤ˧˧
hơi	hɤj˧˧
hơn	hɤn˧˧
hơng	hɤŋ˧˧
hư	hɯ˧˧
hưng	hɯŋ˧˧
hưu	hɯw˧˧
hươm	hɯəm˧˧
hươn	hɯən˧˧
hương	hɯəŋ˧˧
hươu	hɯəw˧˧
hước	hɯək˦˥
hướm	hɯəm˨˦
hướng	hɯəŋ˨˦
hườm	hɯəm˧˨
hường	hɯəŋ˧˨
hưởng	hɯəŋ˧˩˨
hượm	hɯəm˨ˀ˩ʔ
hạ	ha˨ˀ˩ʔ
hạc	hak˨ˀ˩
hạch	hɛk˨ˀ˩
hại	haj˨ˀ˩ʔ
hạm	ham˨ˀ˩ʔ
hạn	han˨ˀ˩ʔ
hạng	haŋ˨ˀ˩ʔ
hạnh	hɛŋ˨ˀ˩ʔ
hạo	haw˨ˀ˩ʔ
hạp	hap˨ˀ˩
hạt	hat˨ˀ˩
hạy	hăj˨ˀ˩ʔ
hả	ha˧˩˨
hải	haj˧˩˨
hảm	ham˧˩˨
hảng	haŋ˧˩˨
hảnh	hɛŋ˧˩˨
hảo	haw˧˩˨
hảy	hăj˧˩˨
hấm	hɤ̆m˨˦
hấn	hɤ̆n˨˦
hấng	hɤ̆ŋ˨˦
hấp	hɤ̆p˦˥
hất	hɤ̆t˦˥
hấu	hɤ̆w˨˦
hấy	hɤ̆j˨˦
hầm	hɤ̆m˧˨
hầu	hɤ̆w˧˨
hầy	hɤ̆j˧˨
hẩm	hɤ̆m˧˩˨
hẩng	hɤ̆ŋ˧˩˨
hẩu	hɤ̆w˧˩˨
hẩy	hɤ̆j˧˩˨
hẫng	hɤ̆ŋ˧ˀ˥
hẫu	hɤ̆w˧ˀ˥
hậm	hɤ̆m˨ˀ˩ʔ
hận	hɤ̆n˨ˀ˩ʔ
hập	hɤ̆p˨ˀ˩
hậu	hɤ̆w˨ˀ˩ʔ
hắc	hăk˦˥
hắn	hăn˨˦
hắng	hăŋ˨˦
hắt	hăt˦˥
hằm	hăm˧˨
hằn	hăn˧˨
hằng	hăŋ˧˨
hẳm	hăm˧˩˨
hẳn	hăn˧˩˨
hẵm	hăm˧ˀ˥
hẵng	hăŋ˧ˀ˥
hặc	hăk˨ˀ˩
hặm	hăm˨ˀ˩ʔ
hẹ	hɛ˨ˀ˩ʔ
hẹm	hɛm˨ˀ˩ʔ
hẹn	hɛn˨ˀ˩ʔ
hẹp	hɛp˨ˀ˩
hẹt	hɛt˨ˀ˩
hẻ	hɛ˧˩˨
hẻm	hɛm˧˩˨
hẻn	hɛn˧˩˨
hẻo	heo˧˩˨
hẽm	hɛm˧ˀ˥
hếch	hek˦˥
hến	hen˨˦
hết	het˦˥
hếu	hɛu˨˦
hề	he˧˨
hềnh	heŋ˧˨
hều	hɛu˧˨
hể	he˧˩˨
hển	hen˧˩˨
hểnh	heŋ˧˩˨
hểu	hɛu˧˩˨
hễ	he˧ˀ˥
hệ	he˨ˀ˩ʔ
hệch	hek˨ˀ˩
hệt	het˨ˀ˩
hỉ	hi˧˩˨
hỉnh	hiŋ˧˩˨
hị	hi˨ˀ˩ʔ
hịch	hik˨ˀ˩
họ	hɔ˨ˀ˩ʔ
họa	hwa˨ˀ˩ʔ
học	hɔk͡p˨ˀ˩
họe	hwe˨ˀ˩ʔ
họng	hɔŋ͡m˨ˀ˩ʔ
họp	hɔp˨ˀ˩
hỏ	hɔ˧˩˨
hỏa	hwa˧˩˨
hỏi	hɔj˧˩˨
hỏm	hɔm˧˩˨
hỏn	hɔn˧˩˨
hỏng	hɔŋ͡m˧˩˨
hố	ho˨˦
hốc	hok͡p˦˥
hối	hoj˨˦
hống	hoŋ͡m˨˦
hốt	hot˦˥
hồ	ho˧˨
hồi	hoj˧˨
hồn	hon˧˨
hồng	hoŋ͡m˧˨
hổ	ho˧˩˨
hổi	hoj˧˩˨
hổm	hom˧˩˨
hổn	hon˧˩˨
hổng	hoŋ͡m˧˩˨
hỗ	ho˧ˀ˥
hỗm	hom˧ˀ˥
hỗn	hon˧ˀ˥
hỗng	hoŋ͡m˧ˀ˥
hộ	ho˨ˀ˩ʔ
hộc	hok͡p˨ˀ˩
hội	hoj˨ˀ˩ʔ
hộn	hon˨ˀ˩ʔ
hộp	hop˨ˀ˩
hột	hot˨ˀ˩
hớ	hɤ˨˦
hớm	hɤm˨˦
hớn	hɤn˨˦
hớp	hɤp˦˥
hớt	hɤt˦˥
hờ	hɤ˧˨
hời	hɤj˧˨
hờm	hɤm˧˨
hờn	hɤn˧˨
hở	hɤ˧˩˨
hởi	hɤj˧˩˨
hởn	hɤn˧˩˨
hỡ	hɤ˧ˀ˥
hỡi	hɤj˧ˀ˥
hỡm	hɤm˧ˀ˥
hợi	hɤj˨ˀ˩ʔ
hợm	hɤm˨ˀ˩ʔ
hợp	hɤp˨ˀ˩
hợt	hɤt˨ˀ˩
hụ	hu˨ˀ˩ʔ
hục	huk͡p˨ˀ˩
hụi	huj˨ˀ˩ʔ
hụm	hum˨ˀ˩ʔ
hụp	hup˨ˀ˩
hụt	hut˨ˀ˩
hủ	hu˧˩˨
hủi	huj˧˩˨
hủm	hum˧˩˨
hủn	hun˧˩˨
hủng	huŋ͡m˧˩˨
hủy	hwi˧˩˨
hứ	hɯ˨˦
hứa	hɯə˨˦
hức	hɯk˦˥
hứng	hɯŋ˨˦
hừ	hɯ˧˨
hừa	hɯə˧˨
hừm	hɯm˧˨
hừng	hɯŋ˧˨
hử	hɯ˧˩˨
hửng	hɯŋ˧˩˨
hữ	hɯ˧ˀ˥
hững	hɯŋ˧ˀ˥
hữu	hɯw˧ˀ˥
hự	hɯ˨ˀ˩ʔ
hực	hɯk˨ˀ˩
hựu	hɯw˨ˀ˩ʔ
hỷ	hi˧˩˨
i	i˧˧
ic	ik˧˧
im	im˧˧
in	in˧˧
inh	iŋ˧˧
iu	iw˧˧
ka	ka˧˧
kan	kan˧˧
kay	kăj˧˧
ke	kɛ˧˧
kem	kɛm˧˧
ken	kɛn˧˧
keng	kɛŋ˧˧
keo	keo˧˧
kha	xa˧˧
khai	xaj˧˧
kham	xam˧˧
khan	xan˧˧
khang	xaŋ˧˧
khanh	xɛŋ˧˧
khao	xaw˧˧
khau	xăw˧˧
khay	xăj˧˧
khe	xɛ˧˧
khem	xɛm˧˧
khen	xɛn˧˧
kheo	xeo˧˧
khi	xi˧˧
khin	xin˧˧
khinh	xiŋ˧˧
khiu	xiw˧˧
khiêm	xiəm˧˧
khiên	xiən˧˧
khiêng	xiəŋ˧˧
khiêu	xiəw˧˧
khiếm	xiəm˨˦
khiến	xiən˨˦
khiếp	xiəp˦˥
khiết	xiət˦˥
khiếu	xiəw˨˦
khiền	xiən˧˨
khiển	xiən˧˩˨
khiểng	xiəŋ˧˩˨
khiễng	xiəŋ˧ˀ˥
khiệng	xiəŋ˨ˀ˩ʔ
kho	xɔ˧˧
khoa	xwa˧˧
khoai	xwaj˧˧
khoan	xwan˧˧
khoang	xwaŋ˧˧
khoanh	xwɛŋ˧˧
khoe	xwe˧˧
khoen	xwen˧˧
khoeo	xwew˧˧
khoi	xɔj˧˧
khom	xɔm˧˧
khoong	xɔɔŋ͡m˧˧
khoành	xwɛŋ˧˨
khoào	xwaw˧˨
khoá	xwa˨˦
khoác	xwak˦˥
khoái	xwaj˨˦
khoán	xwan˨˦
khoáng	xwaŋ˨˦
khoát	xwat˦˥
khoáy	xwăj˨˦
khoèo	xwew˧˨
khoé	xwe˨˦
khoén	xwen˨˦
khoét	xwet˦˥
khoăm	xwăm˧˧
khoăn	xwăn˧˧
khoạng	xwaŋ˨ˀ˩ʔ
khoả	xwa˧˩˨
khoải	xwaj˧˩˨
khoản	xwan˧˩˨
khoảng	xwaŋ˧˩˨
khoảnh	xwɛŋ˧˩˨
khoắm	xwăm˨˦
khoắn	xwăn˨˦
khoắng	xwăŋ˨˦
khoắt	xwăt˦˥
khoằm	xwăm˧˨
khoặm	xwăm˨ˀ˩ʔ
khoẻ	xwe˧˩˨
khoẻo	xwew˧˩˨
khu	xu˧˧
khua	xuə˧˧
khui	xuj˧˧
khum	xum˧˧
khung	xuŋ͡m˧˧
khuy	xwi˧˧
khuya	xwiə˧˧
khuynh	xwiŋ˧˧
khuyên	xwiən˧˧
khuyến	xwiən˨˦
khuyết	xwiət˦˥
khuyển	xwiən˧˩˨
khuân	xwɤ̆n˧˧
khuâng	xwɤ̆ŋ˧˧
khuây	xwɤ̆j˧˧
khuê	xwe˧˧
khuôn	xuən˧˧
khuông	xuəŋ˧˧
khuýp	xwip˦˥
khuơ	xuə˧˧
khuất	xwɤ̆t˦˥
khuấy	xwɤ̆j˨˦
khuẩn	xwɤ̆n˧˩˨
khuắng	xwăŋ˨˦
khuếch	xwek˦˥
khuờ	xuə˧˨
khuỳnh	xwiŋ˧˨
khuỵ	xwi˨ˀ˩ʔ
khuỵu	xwiu˨ˀ˩ʔ
khuỷnh	xwiŋ˧˩˨
khuỷu	xwiu˧˩˨
khyển	xiɛn˧˩˨
khà	xa˧˨
khàn	xan˧˨
khàng	xaŋ˧˨
khành	xɛŋ˧˨
khá	xa˨˦
khác	xak˦˥
khách	xɛk˦˥
khái	xaj˨˦
khám	xam˨˦
khán	xan˨˦
kháng	xaŋ˨˦
khánh	xɛŋ˨˦
kháo	xaw˨˦
kháp	xap˦˥
khát	xat˦˥
kháu	xăw˨˦
kháy	xăj˨˦
khâm	xɤ̆m˧˧
khân	xɤ̆n˧˧
khâng	xɤ̆ŋ˧˧
khâu	xɤ̆w˧˧
khè	xɛ˧˨
khèn	xɛn˧˨
khèng	xɛŋ˧˨
khèo	xeo˧˨
khé	xɛ˨˦
khén	xɛn˨˦
khéo	xeo˨˦
khép	xɛp˦˥
khét	xɛt˦˥
khê	xe˧˧
khênh	xeŋ˧˧
khêu	xɛu˧˧
khì	xi˧˨
khìn	xin˧˨
khí	xi˨˦
khía	xiə˨˦
khích	xik˦˥
khín	xin˨˦
khít	xit˦˥
khíu	xiw˨˦
khò	xɔ˧˨
khòe	xwe˧˨
khòm	xɔm˧˨
khòn	xɔn˧˨
khòng	xɔŋ͡m˧˨
khó	xɔ˨˦
khóa	xwa˨˦
khóc	xɔk͡p˦˥
khóe	xwe˨˦
khói	xɔj˨˦
khóm	xɔm˨˦
khô	xo˧˧
khôi	xoj˧˧
khôn	xon˧˧
không	xoŋ͡m˧˧
khôống	xoŋ͡m˨˦
khù	xu˧˨
khùa	xuə˧˨
khùng	xuŋ͡m˧˨
khú	xu˨˦
khúc	xuk͡p˦˥
khúm	xum˨˦
khúng	xuŋ͡m˨˦
khăm	xăm˧˧
khăn	xăn˧˧
khăng	xăŋ˧˧
khĩnh	xiŋ˧ˀ˥
khơ	xɤ˧˧
khơi	xɤj˧˧
khư	xɯ˧˧
khươi	xɯəj˧˧
khươm	xɯəm˧˧
khươn	xɯən˧˧
khương	xɯəŋ˧˧
khước	xɯək˦˥
khướt	xɯət˦˥
khướu	xɯəw˨˦
khưởng	xɯəŋ˧˩˨
khưỡng	xɯəŋ˧ˀ˥
khượt	xɯət˨ˀ˩
khạ	xa˨ˀ˩ʔ
khạc	xak˨ˀ˩
khạch	xɛk˨ˀ˩
khạng	xaŋ˨ˀ˩ʔ
khạo	xaw˨ˀ˩ʔ
khạp	xap˨ˀ˩
khả	xa˧˩˨
khảch	xɛk˧˩˨
khải	xaj˧˩˨
khảm	xam˧˩˨
khản	xan˧˩˨
khảng	xaŋ˧˩˨
khảnh	xɛŋ˧˩˨
khảo	xaw˧˩˨
khảy	xăj˧˩˨
khấc	xɤ̆k˦˥
khấm	xɤ̆m˨˦
khấn	xɤ̆n˨˦
khấp	xɤ̆p˦˥
khất	xɤ̆t˦˥
khấu	xɤ̆w˨˦
khầng	xɤ̆ŋ˧˨
khẩn	xɤ̆n˧˩˨
khẩu	xɤ̆w˧˩˨
khẩy	xɤ̆j˧˩˨
khậc	xɤ̆k˨ˀ˩
khậm	xɤ̆m˨ˀ˩ʔ
khập	xɤ̆p˨ˀ˩
khật	xɤ̆t˨ˀ˩
khắc	xăk˦˥
khắm	xăm˨˦
khắn	xăn˨˦
khắng	xăŋ˨˦
khắp	xăp˦˥
khắt	xăt˦˥
khằn	xăn˧˨
khằng	xăŋ˧˨
khẳm	xăm˧˩˨
khẳn	xăn˧˩˨
khẳng	xăŋ˧˩˨
khặc	xăk˨ˀ˩
khẹc	xɛk˨ˀ˩
khẻ	xɛ˧˩˨
khẻo	xeo˧˩˨
khẽ	xɛ˧ˀ˥
khế	xe˨˦
khề	xe˧˨
khềnh	xeŋ˧˨
khều	xɛu˧˨
khểnh	xeŋ˧˩˨
khễnh	xeŋ˧ˀ˥
khệ	xe˨ˀ˩ʔ
khệch	xek˨ˀ˩
khệnh	xeŋ˨ˀ˩ʔ
khỉ	xi˧˩˨
khỉnh	xiŋ˧˩˨
khị	xi˨ˀ˩ʔ
khịa	xiə˨ˀ˩ʔ
khịt	xit˨ˀ˩
khịu	xiw˨ˀ˩ʔ
khọm	xɔm˨ˀ˩ʔ
khọt	xɔt˨ˀ˩
khỏ	xɔ˧˩˨
khỏa	xwa˧˩˨
khỏe	xwe˧˩˨
khỏi	xɔj˧˩˨
khỏng	xɔŋ͡m˧˩˨
khố	xo˨˦
khốc	xok͡p˦˥
khối	xoj˨˦
khốn	xon˨˦
khống	xoŋ͡m˨˦
khổ	xo˧˩˨
khổn	xon˧˩˨
khổng	xoŋ͡m˧˩˨
khớ	xɤ˨˦
khới	xɤj˨˦
khớp	xɤp˦˥
khờ	xɤ˧˨
khởi	xɤj˧˩˨
khụ	xu˨ˀ˩ʔ
khục	xuk͡p˨ˀ˩
khụng	xuŋ͡m˨ˀ˩ʔ
khụt	xut˨ˀ˩
khụy	xwi˨ˀ˩ʔ
khủ	xu˧˩˨
khủa	xuə˧˩˨
khủng	xuŋ͡m˧˩˨
khứ	xɯ˨˦
khứa	xɯə˨˦
khứng	xɯŋ˨˦
khứu	xɯw˨˦
khừ	xɯ˧˨
khừa	xɯə˧˨
khừng	xɯŋ˧˨
khử	xɯ˧˩˨
khự	xɯ˨ˀ˩ʔ
khựng	xɯŋ˨ˀ˩ʔ
ki	ki˧˧
kia	kiə˧˧
kim	kim˧˧
kin	kin˧˧
kinh	kiŋ˧˧
kip	kip˧˧
kiu	kiw˧˧
kiêm	kiəm˧˧
kiên	kiən˧˧
kiêng	kiəŋ˧˧
kiêu	kiəw˧˧
kiếm	kiəm˨˦
kiến	kiən˨˦
kiếng	kiəŋ˨˦
kiếp	kiəp˦˥
kiết	kiət˦˥
kiếu	kiəw˨˦
kiềm	kiəm˧˨
kiền	kiən˧˨
kiềng	kiəŋ˧˨
kiều	kiəw˧˨
kiểm	kiəm˧˩˨
kiểng	kiəŋ˧˩˨
kiểu	kiəw˧˩˨
kiễng	kiəŋ˧ˀ˥
kiệm	kiəm˨ˀ˩ʔ
kiện	kiən˨ˀ˩ʔ
kiệt	kiət˨ˀ˩
kiệu	kiəw˨ˀ˩ʔ
ku	ku˧˧
kuênh	kweŋ˧˧
kuýp	kwip˦˥
ky	ki˧˧
káp	kap˦˥
kè	kɛ˧˨
kèm	kɛm˧˨
kèn	kɛn˧˨
kèo	keo˧˨
ké	kɛ˨˦
kéc	kɛk˦˥
kém	kɛm˨˦
kén	kɛn˨˦
kéo	keo˨˦
kép	kɛp˦˥
két	kɛt˦˥
kê	ke˧˧
kên	ken˧˧
kêng	keŋ˧˧
kênh	keŋ˧˧
kêu	kɛu˧˧
kì	ki˧˨
kìa	kiə˧˨
kìm	kim˧˨
kìn	kin˧˨
kình	kiŋ˧˨
kí	ki˨˦
kích	kik˦˥
kín	kin˨˦
kính	kiŋ˨˦
kíp	kip˦˥
kít	kit˦˥
kíu	kiw˨˦
kót	kɔt˦˥
kôn	kon˧˧
ký	ki˨˦
kĩ	ki˧ˀ˥
kĩn	kin˧ˀ˥
kĩu	kiw˧ˀ˥
kơi	kɤj˧˧
kạn	kan˨ˀ˩ʔ
kẹ	kɛ˨ˀ˩ʔ
kẹn	kɛn˨ˀ˩ʔ
kẹo	keo˨ˀ˩ʔ
kẹp	kɛp˨ˀ˩
kẹt	kɛt˨ˀ˩
kẻ	kɛ˧˩˨
kẻm	kɛm˧˩˨
kẻng	kɛŋ˧˩˨
kẻo	keo˧˩˨
kẽ	kɛ˧ˀ˥
kẽm	kɛm˧ˀ˥
kẽo	keo˧ˀ˥
kế	ke˨˦
kếch	kek˦˥
kếp	kep˦˥
kết	ket˦˥
kếu	kɛu˨˦
kề	ke˧˨
kềm	kem˧˨
kền	ken˧˨
kềnh	keŋ˧˨
kều	kɛu˧˨
kể	ke˧˩˨
kễnh	keŋ˧ˀ˥
kệ	ke˨ˀ˩ʔ
kệch	kek˨ˀ˩
kệnh	keŋ˨ˀ˩ʔ
kỉ	ki˧˩˨
kỉnh	kiŋ˧˩˨
kị	ki˨ˀ˩ʔ
kịa	kiə˨ˀ˩ʔ
kịch	kik˨ˀ˩
kịp	kip˨ˀ˩
kịt	kit˨ˀ˩
kốc	kok͡p˦˥
kỳ	ki˧˨
kỵ	ki˨ˀ˩ʔ
kỷ	ki˧˩˨
kỹ	ki˧ˀ˥
la	la˧˧
lai	laj˧˧
lam	lam˧˧
lan	lan˧˧
lang	laŋ˧˧
lanh	lɛŋ˧˧
lao	law˧˧
lat	lat˧˧
lau	lăw˧˧
lay	lăj˧˧
le	lɛ˧˧
lem	lɛm˧˧
len	lɛn˧˧
leng	lɛŋ˧˧
leo	leo˧˧
li	li˧˧
lia	liə˧˧
lic	lik˧˧
lim	lim˧˧
lin	lin˧˧
linh	liŋ˧˧
lit	lit˧˧
liu	liw˧˧
liêm	liəm˧˧
liên	liən˧˧
liêng	liəŋ˧˧
liêu	liəw˧˧
liếc	liək˦˥
liếm	liəm˨˦
liến	liən˨˦
liếng	liəŋ˨˦
liếp	liəp˦˥
liếu	liəw˨˦
liềm	liəm˧˨
liền	liən˧˨
liềng	liəŋ˧˨
liều	liəw˧˨
liểng	liəŋ˧˩˨
liễm	liəm˧ˀ˥
liễn	liən˧ˀ˥
liễu	liəw˧ˀ˥
liệc	liək˨ˀ˩
liệm	liəm˨ˀ˩ʔ
liệng	liəŋ˨ˀ˩ʔ
liệp	liəp˨ˀ˩
liệt	liət˨ˀ˩
liệu	liəw˨ˀ˩ʔ
lo	lɔ˧˧
loa	lwa˧˧
loai	lwaj˧˧
loan	lwan˧˧
loang	lwaŋ˧˧
loanh	lwɛŋ˧˧
loay	lwăj˧˧
loe	lwe˧˧
loen	lwen˧˧
loi	lɔj˧˧
lom	lɔm˧˧
lon	lɔn˧˧
long	lɔŋ͡m˧˧
loong	lɔɔŋ͡m˧˧
loà	lwa˧˨
loài	lwaj˧˨
loàn	lwan˧˨
loàng	lwaŋ˧˨
loá	lwa˨˦
loác	lwak˦˥
loán	lwan˨˦
loáng	lwaŋ˨˦
loáo	lwaw˨˦
loát	lwat˦˥
loáy	lwăj˨˦
loã	lwa˧ˀ˥
loãng	lwaŋ˧ˀ˥
loè	lwe˧˨
loé	lwe˨˦
loét	lwet˦˥
loòng	lɔɔŋ͡m˧˨
loăn	lwăn˧˧
loăng	lwăŋ˧˧
loạc	lwak˨ˀ˩
loạch	lwɛk˨ˀ˩
loại	lwaj˨ˀ˩ʔ
loạn	lwan˨ˀ˩ʔ
loạng	lwaŋ˨ˀ˩ʔ
loạt	lwat˨ˀ˩
loả	lwa˧˩˨
loảng	lwaŋ˧˩˨
loắn	lwăn˨˦
loắt	lwăt˦˥
loằn	lwăn˧˨
loằng	lwăŋ˧˨
loẹt	lwet˨ˀ˩
loẻng	lweŋ˧˩˨
loẻo	lwew˧˩˨
lu	lu˧˧
lua	luə˧˧
lui	luj˧˧
lum	lum˧˧
lung	luŋ͡m˧˧
luy	lwi˧˧
luya	lwiə˧˧
luyn	lwin˧˧
luyên	lwiən˧˧
luyến	lwiən˨˦
luyện	lwiən˨ˀ˩ʔ
luân	lwɤ̆n˧˧
luôm	luəm˧˧
luôn	luən˧˧
luông	luəŋ˧˧
luý	lwi˨˦
luých	lwik˦˥
luýnh	lwiŋ˨˦
luýt	lwit˦˥
luấn	lwɤ̆n˨˦
luẩn	lwɤ̆n˧˩˨
luận	lwɤ̆n˨ˀ˩ʔ
luật	lwɤ̆t˨ˀ˩
luốc	luək˦˥
luống	luəŋ˨˦
luốt	luət˦˥
luồi	luəj˧˨
luồn	luən˧˨
luồng	luəŋ˧˨
luỗng	luəŋ˧ˀ˥
luộc	luək˨ˀ˩
luộm	luəm˨ˀ˩ʔ
luột	luət˨ˀ˩
luỵ	lwi˨ˀ˩ʔ
luỹ	lwi˧ˀ˥
ly	li˧˧
là	la˧˨
lài	laj˧˨
làm	lam˧˨
làn	lan˧˨
làng	laŋ˧˨
lành	lɛŋ˧˨
lào	law˧˨
làu	lăw˧˨
lày	lăj˧˨
lá	la˨˦
lác	lak˦˥
lách	lɛk˦˥
lái	laj˨˦
lán	lan˨˦
láng	laŋ˨˦
lánh	lɛŋ˨˦
láo	law˨˦
láp	lap˦˥
lát	lat˦˥
láu	lăw˨˦
láy	lăj˨˦
lâm	lɤ̆m˧˧
lân	lɤ̆n˧˧
lâng	lɤ̆ŋ˧˧
lâp	lɤ̆p˧˧
lâu	lɤ̆w˧˧
lây	lɤ̆j˧˧
lã	la˧ˀ˥
lãi	laj˧ˀ˥
lãm	lam˧ˀ˥
lãn	lan˧ˀ˥
lãng	laŋ˧ˀ˥
lãnh	lɛŋ˧ˀ˥
lão	law˧ˀ˥
lè	lɛ˧˨
lèm	lɛm˧˨
lèn	lɛn˧˨
lèng	lɛŋ˧˨
lèo	leo˧˨
lé	lɛ˨˦
léc	lɛk˦˥
lém	lɛm˨˦
lén	lɛn˨˦
léng	lɛŋ˨˦
léo	leo˨˦
lép	lɛp˦˥
lét	lɛt˦˥
lê	le˧˧
lêc	lek˧˧
lên	len˧˧
lênh	leŋ˧˧
lêu	lɛu˧˧
lì	li˧˨
lìa	liə˧˨
lìm	lim˧˨
lìn	lin˧˨
lình	liŋ˧˨
lìu	liw˧˨
lí	li˨˦
lía	liə˨˦
líc	lik˦˥
lích	lik˦˥
lính	liŋ˨˦
líp	lip˦˥
lít	lit˦˥
líu	liw˨˦
lò	lɔ˧˨
lòa	lwa˧˨
lòe	lwe˧˨
lòi	lɔj˧˨
lòm	lɔm˧˨
lòn	lɔn˧˨
lòng	lɔŋ͡m˧˨
ló	lɔ˨˦
lóc	lɔk͡p˦˥
lóe	lwe˨˦
lói	lɔj˨˦
lóm	lɔm˨˦
lóng	lɔŋ͡m˨˦
lóp	lɔp˦˥
lót	lɔt˦˥
lô	lo˧˧
lôi	loj˧˧
lôm	lom˧˧
lôn	lon˧˧
lông	loŋ͡m˧˧
lõ	lɔ˧ˀ˥
lõa	lwa˧ˀ˥
lõi	lɔj˧ˀ˥
lõm	lɔm˧ˀ˥
lõng	lɔŋ͡m˧ˀ˥
lù	lu˧˨
lùa	luə˧˨
lùi	luj˧˨
lùm	lum˧˨
lùn	lun˧˨
lùng	luŋ͡m˧˨
lú	lu˨˦
lúa	luə˨˦
lúc	luk͡p˦˥
lúi	luj˨˦
lúm	lum˨˦
lún	lun˨˦
lúng	luŋ͡m˨˦
lúp	lup˦˥
lút	lut˦˥
lúy	lwi˨˦
lý	li˨˦
lăm	lăm˧˧
lăn	lăn˧˧
lăng	lăŋ˧˧
lĩ	li˧ˀ˥
lĩnh	liŋ˧ˀ˥
lũ	lu˧ˀ˥
lũa	luə˧ˀ˥
lũi	luj˧ˀ˥
lũm	lum˧ˀ˥
lũn	lun˧ˀ˥
lũng	luŋ͡m˧ˀ˥
lũy	lwi˧ˀ˥
lơ	lɤ˧˧
lơi	lɤj˧˧
lơn	lɤn˧˧
lơng	lɤŋ˧˧
lư	lɯ˧˧
lưa	lɯə˧˧
lưng	lɯŋ˧˧
lưu	lɯw˧˧
lươm	lɯəm˧˧
lươn	lɯən˧˧
lương	lɯəŋ˧˧
lưới	lɯəj˨˦
lướng	lɯəŋ˨˦
lướp	lɯəp˦˥
lướt	lɯət˦˥
lướu	lɯəw˨˦
lười	lɯəj˧˨
lườm	lɯəm˧˨
lườn	lɯən˧˨
lường	lɯəŋ˧˨
lưởi	lɯəj˧˩˨
lưởng	lɯəŋ˧˩˨
lưỡi	lɯəj˧ˀ˥
lưỡng	lɯəŋ˧ˀ˥
lược	lɯək˨ˀ˩
lượm	lɯəm˨ˀ˩ʔ
lượn	lɯən˨ˀ˩ʔ
lượng	lɯəŋ˨ˀ˩ʔ
lượt	lɯət˨ˀ˩
lạ	la˨ˀ˩ʔ
lạc	lak˨ˀ˩
lạch	lɛk˨ˀ˩
lại	laj˨ˀ˩ʔ
lạm	lam˨ˀ˩ʔ
lạn	lan˨ˀ˩ʔ
lạng	laŋ˨ˀ˩ʔ
lạnh	lɛŋ˨ˀ˩ʔ
lạo	law˨ˀ˩ʔ
lạp	lap˨ˀ˩
lạt	lat˨ˀ˩
lạu	lăw˨ˀ˩ʔ
lạy	lăj˨ˀ˩ʔ
lả	la˧˩˨
lải	laj˧˩˨
lảm	lam˧˩˨
lảng	laŋ˧˩˨
lảnh	lɛŋ˧˩˨
lảo	law˧˩˨
lảu	lăw˧˩˨
lảy	lăj˧˩˨
lấc	lɤ̆k˦˥
lấm	lɤ̆m˨˦
lấn	lɤ̆n˨˦
lấp	lɤ̆p˦˥
lất	lɤ̆t˦˥
lấu	lɤ̆w˨˦
lấy	lɤ̆j˨˦
lầm	lɤ̆m˧˨
lần	lɤ̆n˧˨
lầu	lɤ̆w˧˨
lầy	lɤ̆j˧˨
lẩm	lɤ̆m˧˩˨
lẩn	lɤ̆n˧˩˨
lẩu	lɤ̆w˧˩˨
lẩy	lɤ̆j˧˩˨
lẫm	lɤ̆m˧ˀ˥
lẫn	lɤ̆n˧ˀ˥
lẫy	lɤ̆j˧ˀ˥
lận	lɤ̆n˨ˀ˩ʔ
lập	lɤ̆p˨ˀ˩
lật	lɤ̆t˨ˀ˩
lậu	lɤ̆w˨ˀ˩ʔ
lậy	lɤ̆j˨ˀ˩ʔ
lắc	lăk˦˥
lắm	lăm˨˦
lắng	lăŋ˨˦
lắp	lăp˦˥
lắt	lăt˦˥
lằm	lăm˧˨
lằn	lăn˧˨
lằng	lăŋ˧˨
lẳm	lăm˧˩˨
lẳn	lăn˧˩˨
lẳng	lăŋ˧˩˨
lẵng	lăŋ˧ˀ˥
lặc	lăk˨ˀ˩
lặm	lăm˨ˀ˩ʔ
lặn	lăn˨ˀ˩ʔ
lặng	lăŋ˨ˀ˩ʔ
lặp	lăp˨ˀ˩
lặt	lăt˨ˀ˩
lẹ	lɛ˨ˀ˩ʔ
lẹm	lɛm˨ˀ˩ʔ
lẹn	lɛn˨ˀ˩ʔ
lẹo	leo˨ˀ˩ʔ
lẹp	lɛp˨ˀ˩
lẹt	lɛt˨ˀ˩
lẻ	lɛ˧˩˨
lẻm	lɛm˧˩˨
lẻn	lɛn˧˩˨
lẻng	lɛŋ˧˩˨
lẻo	leo˧˩˨
lẽ	lɛ˧ˀ˥
lẽn	lɛn˧ˀ˥
lẽo	leo˧ˀ˥
lếc	lek˦˥
lếch	lek˦˥
lếp	lep˦˥
lết	let˦˥
lếu	lɛu˨˦
lề	le˧˨
lềnh	leŋ˧˨
lều	lɛu˧˨
lể	le˧˩˨
lểu	lɛu˧˩˨
lễ	le˧ˀ˥
lễu	lɛu˧ˀ˥
lệ	le˨ˀ˩ʔ
lệch	lek˨ˀ˩
lệnh	leŋ˨ˀ˩ʔ
lệt	let˨ˀ˩
lỉm	lim˧˩˨
lỉnh	liŋ˧˩˨
lỉu	liw˧˩˨
lị	li˨ˀ˩ʔ
lịa	liə˨ˀ˩ʔ
lịch	lik˨ˀ˩
lịm	lim˨ˀ˩ʔ
lịnh	liŋ˨ˀ˩ʔ
lịu	liw˨ˀ˩ʔ
lọ	lɔ˨ˀ˩ʔ
lọc	lɔk͡p˨ˀ˩
lọi	lɔj˨ˀ˩ʔ
lọm	lɔm˨ˀ˩ʔ
lọn	lɔn˨ˀ˩ʔ
lọng	lɔŋ͡m˨ˀ˩ʔ
lọp	lɔp˨ˀ˩
lọt	lɔt˨ˀ˩
lỏa	lwa˧˩˨
lỏi	lɔj˧˩˨
lỏm	lɔm˧˩˨
lỏn	lɔn˧˩˨
lỏng	lɔŋ͡m˧˩˨
lố	lo˨˦
lốc	lok͡p˦˥
lối	loj˨˦
lốm	lom˨˦
lốn	lon˨˦
lốp	lop˦˥
lốt	lot˦˥
lồ	lo˧˨
lồi	loj˧˨
lồm	lom˧˨
lồn	lon˧˨
lồng	loŋ͡m˧˨
lổ	lo˧˩˨
lổm	lom˧˩˨
lổn	lon˧˩˨
lổng	loŋ͡m˧˩˨
lỗ	lo˧ˀ˥
lỗi	loj˧ˀ˥
lỗm	lom˧ˀ˥
lộ	lo˨ˀ˩ʔ
lộc	lok͡p˨ˀ˩
lội	loj˨ˀ˩ʔ
lộm	lom˨ˀ˩ʔ
lộn	lon˨ˀ˩ʔ
lộng	loŋ͡m˨ˀ˩ʔ
lộp	lop˨ˀ˩
lột	lot˨ˀ˩
lớ	lɤ˨˦
lới	lɤj˨˦
lớn	lɤn˨˦
lớp	lɤp˦˥
lớt	lɤt˦˥
lờ	lɤ˧˨
lời	lɤj˧˨
lờm	lɤm˧˨
lờn	lɤn˧˨
lở	lɤ˧˩˨
lởi	lɤj˧˩˨
lởm	lɤm˧˩˨
lởn	lɤn˧˩˨
lỡ	lɤ˧ˀ˥
lỡi	lɤj˧ˀ˥
lỡm	lɤm˧ˀ˥
lợ	lɤ˨ˀ˩ʔ
lợi	lɤj˨ˀ˩ʔ
lợm	lɤm˨ˀ˩ʔ
lợn	lɤn˨ˀ˩ʔ
lợp	lɤp˨ˀ˩
lợt	lɤt˨ˀ˩
lụ	lu˨ˀ˩ʔ
lụa	luə˨ˀ˩ʔ
lục	luk͡p˨ˀ˩
lụi	luj˨ˀ˩ʔ
lụm	lum˨ˀ˩ʔ
lụn	lun˨ˀ˩ʔ
lụng	luŋ͡m˨ˀ˩ʔ
lụp	lup˨ˀ˩
lụt	lut˨ˀ˩
lụy	lwi˨ˀ˩ʔ
lủ	lu˧˩˨
lủa	luə˧˩˨
lủi	luj˧˩˨
lủm	lum˧˩˨
lủn	lun˧˩˨
lủng	luŋ͡m˧˩˨
lứa	lɯə˨˦
lức	lɯk˦˥
lứt	lɯt˦˥
lừ	lɯ˧˨
lừa	lɯə˧˨
lừng	lɯŋ˧˨
lử	lɯ˧˩˨
lửa	lɯə˧˩˨
lửng	lɯŋ˧˩˨
lữ	lɯ˧ˀ˥
lữa	lɯə˧ˀ˥
lững	lɯŋ˧ˀ˥
lự	lɯ˨ˀ˩ʔ
lựa	lɯə˨ˀ˩ʔ
lực	lɯk˨ˀ˩
lựng	lɯŋ˨ˀ˩ʔ
lựu	lɯw˨ˀ˩ʔ
lỵ	li˨ˀ˩ʔ
lỹ	li˧ˀ˥
ma	ma˧˧
mai	maj˧˧
mam	mam˧˧
man	man˧˧
mang	maŋ˧˧
manh	mɛŋ˧˧
mao	maw˧˧
mau	măw˧˧
may	măj˧˧
me	mɛ˧˧
mem	mɛm˧˧
men	mɛn˧˧
meo	meo˧˧
mi	mi˧˧
mia	miə˧˧
mim	mim˧˧
min	min˧˧
minh	miŋ˧˧
misa	misa˧˧
miu	miw˧˧
miên	miən˧˧
miêu	miəw˧˧
miến	miən˨˦
miếng	miəŋ˨˦
miết	miət˦˥
miếu	miəw˨˦
miền	miən˧˨
miều	miəw˧˨
miểng	miəŋ˧˩˨
miễn	miən˧ˀ˥
miễu	miəw˧ˀ˥
miện	miən˨ˀ˩ʔ
miệng	miəŋ˨ˀ˩ʔ
miệt	miət˨ˀ˩
mo	mɔ˧˧
moa	mwa˧˧
moan	mwan˧˧
moay	mwăj˧˧
moi	mɔj˧˧
mom	mɔm˧˧
mon	mɔn˧˧
mong	mɔŋ͡m˧˧
moong	mɔɔŋ͡m˧˧
moóc	mɔɔk͡p˦˥
moọc	mɔɔk͡p˨ˀ˩
mu	mu˧˧
mua	muə˧˧
mui	muj˧˧
mum	mum˧˧
mun	mun˧˧
mung	muŋ͡m˧˧
muy	mwi˧˧
muya	mwiə˧˧
muôi	muəj˧˧
muôn	muən˧˧
muông	muəŋ˧˧
muối	muəj˨˦
muốn	muən˨˦
muống	muəŋ˨˦
muốt	muət˦˥
muồi	muəj˧˨
muồm	muəm˧˨
muồng	muəŋ˧˨
muỗi	muəj˧ˀ˥
muỗm	muəm˧ˀ˥
muỗng	muəŋ˧ˀ˥
muội	muəj˨ˀ˩ʔ
muộn	muən˨ˀ˩ʔ
my	mi˧˧
mà	ma˧˨
mài	maj˧˨
màn	man˧˨
màng	maŋ˧˨
mành	mɛŋ˧˨
mào	maw˧˨
màu	măw˧˨
mày	măj˧˨
má	ma˨˦
mác	mak˦˥
mách	mɛk˦˥
mái	maj˨˦
mám	mam˨˦
mán	man˨˦
máng	maŋ˨˦
mánh	mɛŋ˨˦
máo	maw˨˦
mát	mat˦˥
máu	măw˨˦
máy	măj˨˦
mâm	mɤ̆m˧˧
mân	mɤ̆n˧˧
mâng	mɤ̆ŋ˧˧
mâp	mɤ̆p˧˧
mâu	mɤ̆w˧˧
mây	mɤ̆j˧˧
mã	ma˧ˀ˥
mãi	maj˧ˀ˥
mãn	man˧ˀ˥
mãng	maŋ˧ˀ˥
mãnh	mɛŋ˧ˀ˥
mão	maw˧ˀ˥
mè	mɛ˧˨
mèm	mɛm˧˨
mèn	mɛn˧˨
mèng	mɛŋ˧˨
mèo	meo˧˨
mé	mɛ˨˦
méc	mɛk˦˥
mém	mɛm˨˦
mén	mɛn˨˦
méo	meo˨˦
mép	mɛp˦˥
mét	mɛt˦˥
mê	me˧˧
mên	men˧˧
mênh	meŋ˧˧
mêu	mɛu˧˧
mì	mi˧˨
mìn	min˧˨
mình	miŋ˧˨
mí	mi˨˦
mía	miə˨˦
mích	mik˦˥
mím	mim˨˦
míp	mip˦˥
mít	mit˦˥
míu	miw˨˦
mò	mɔ˧˨
mòi	mɔj˧˨
mòm	mɔm˧˨
mòn	mɔn˧˨
mòng	mɔŋ͡m˧˨
mó	mɔ˨˦
móc	mɔk͡p˦˥
mói	mɔj˨˦
móm	mɔm˨˦
món	mɔn˨˦
móng	mɔŋ͡m˨˦
móp	mɔp˦˥
mót	mɔt˦˥
mô	mo˧˧
môi	moj˧˧
môm	mom˧˧
môn	mon˧˧
mông	moŋ͡m˧˧
môt	mot˧˧
mõ	mɔ˧ˀ˥
mõm	mɔm˧ˀ˥
mù	mu˧˨
mùa	muə˧˨
mùi	muj˧˨
mùn	mun˧˨
mùng	muŋ͡m˧˨
mú	mu˨˦
múa	muə˨˦
múc	muk͡p˦˥
múi	muj˨˦
múm	mum˨˦
mún	mun˨˦
múp	mup˦˥
mút	mut˦˥
măm	măm˧˧
măn	măn˧˧
măng	măŋ˧˧
mĩ	mi˧ˀ˥
mĩm	mim˧ˀ˥
mũ	mu˧ˀ˥
mũi	muj˧ˀ˥
mũm	mum˧ˀ˥
mơ	mɤ˧˧
mơi	mɤj˧˧
mơn	mɤn˧˧
mưa	mɯə˧˧
mưng	mɯŋ˧˧
mưu	mɯw˧˧
mươi	mɯəj˧˧
mươn	mɯən˧˧
mương	mɯəŋ˧˧
mướn	mɯən˨˦
mướp	mɯəp˦˥
mướt	mɯət˦˥
mười	mɯəj˧˨
mườn	mɯən˧˨
mường	mɯəŋ˧˨
mưởi	mɯəj˧˩˨
mược	mɯək˨ˀ˩
mượn	mɯən˨ˀ˩ʔ
mượt	mɯət˨ˀ˩
mạ	ma˨ˀ˩ʔ
mạc	mak˨ˀ˩
mạch	mɛk˨ˀ˩
mại	maj˨ˀ˩ʔ
mạn	man˨ˀ˩ʔ
mạng	maŋ˨ˀ˩ʔ
mạnh	mɛŋ˨ˀ˩ʔ
mạo	maw˨ˀ˩ʔ
mạp	map˨ˀ˩
mạt	mat˨ˀ˩
mạy	măj˨ˀ˩ʔ
mả	ma˧˩˨
mải	maj˧˩˨
mảng	maŋ˧˩˨
mảnh	mɛŋ˧˩˨
mảy	măj˧˩˨
mấm	mɤ̆m˨˦
mấn	mɤ̆n˨˦
mấp	mɤ̆p˦˥
mất	mɤ̆t˦˥
mấu	mɤ̆w˨˦
mấy	mɤ̆j˨˦
mầm	mɤ̆m˧˨
mần	mɤ̆n˧˨
mầng	mɤ̆ŋ˧˨
mầu	mɤ̆w˧˨
mầy	mɤ̆j˧˨
mẩm	mɤ̆m˧˩˨
mẩn	mɤ̆n˧˩˨
mẩu	mɤ̆w˧˩˨
mẩy	mɤ̆j˧˩˨
mẫm	mɤ̆m˧ˀ˥
mẫn	mɤ̆n˧ˀ˥
mẫu	mɤ̆w˧ˀ˥
mậm	mɤ̆m˨ˀ˩ʔ
mận	mɤ̆n˨ˀ˩ʔ
mập	mɤ̆p˨ˀ˩
mật	mɤ̆t˨ˀ˩
mậu	mɤ̆w˨ˀ˩ʔ
mậy	mɤ̆j˨ˀ˩ʔ
mắc	măk˦˥
mắm	măm˨˦
mắn	măn˨˦
mắng	măŋ˨˦
mắt	măt˦˥
mằn	măn˧˨
mẳn	măn˧˩˨
mẵm	măm˧ˀ˥
mặc	măk˨ˀ˩
mặn	măn˨ˀ˩ʔ
mặt	măt˨ˀ˩
mẹ	mɛ˨ˀ˩ʔ
mẹc	mɛk˨ˀ˩
mẹo	meo˨ˀ˩ʔ
mẹp	mɛp˨ˀ˩
mẹt	mɛt˨ˀ˩
mẻ	mɛ˧˩˨
mẻo	meo˧˩˨
mẽ	mɛ˧ˀ˥
mế	me˨˦
mếch	mek˦˥
mến	men˨˦
mết	met˦˥
mếu	mɛu˨˦
mề	me˧˨
mềm	mem˧˨
mền	men˧˨
mể	me˧˩˨
mễ	me˧ˀ˥
mệ	me˨ˀ˩ʔ
mệnh	meŋ˨ˀ˩ʔ
mệt	met˨ˀ˩
mỉ	mi˧˩˨
mỉa	miə˧˩˨
mỉm	mim˧˩˨
mỉu	miw˧˩˨
mị	mi˨ˀ˩ʔ
mịch	mik˨ˀ˩
mịn	min˨ˀ˩ʔ
mịnh	miŋ˨ˀ˩ʔ
mịt	mit˨ˀ˩
mọ	mɔ˨ˀ˩ʔ
mọc	mɔk͡p˨ˀ˩
mọi	mɔj˨ˀ˩ʔ
mọn	mɔn˨ˀ˩ʔ
mọng	mɔŋ͡m˨ˀ˩ʔ
mọp	mɔp˨ˀ˩
mọt	mɔt˨ˀ˩
mỏ	mɔ˧˩˨
mỏi	mɔj˧˩˨
mỏm	mɔm˧˩˨
mỏng	mɔŋ͡m˧˩˨
mố	mo˨˦
mốc	mok͡p˦˥
mối	moj˨˦
mống	moŋ͡m˨˦
mốt	mot˦˥
mồ	mo˧˨
mồi	moj˧˨
mồm	mom˧˨
mồn	mon˧˨
mồng	moŋ͡m˧˨
mổ	mo˧˩˨
mổng	moŋ͡m˧˩˨
mỗ	mo˧ˀ˥
mỗi	moj˧ˀ˥
mộ	mo˨ˀ˩ʔ
mộc	mok͡p˨ˀ˩
mội	moj˨ˀ˩ʔ
mộng	moŋ͡m˨ˀ˩ʔ
một	mot˨ˀ˩
mớ	mɤ˨˦
mới	mɤj˨˦
mớm	mɤm˨˦
mớn	mɤn˨˦
mớp	mɤp˦˥
mờ	mɤ˧˨
mời	mɤj˧˨
mờm	mɤm˧˨
mở	mɤ˧˩˨
mởn	mɤn˧˩˨
mỡ	mɤ˧ˀ˥
mợ	mɤ˨ˀ˩ʔ
mụ	mu˨ˀ˩ʔ
mục	muk͡p˨ˀ˩
mụi	muj˨ˀ˩ʔ
mụn	mun˨ˀ˩ʔ
mụp	mup˨ˀ˩
mụt	mut˨ˀ˩
mủ	mu˧˩˨
mủi	muj˧˩˨
mủm	mum˧˩˨
mủn	mun˧˩˨
mủng	muŋ͡m˧˩˨
mứa	mɯə˨˦
mức	mɯk˦˥
mứn	mɯn˨˦
mứt	mɯt˦˥
mứu	mɯw˨˦
mừng	mɯŋ˧˨
mửa	mɯə˧˩˨
mửng	mɯŋ˧˩˨
mự	mɯ˨ˀ˩ʔ
mựa	mɯə˨ˀ˩ʔ
mực	mɯk˨ˀ˩
mỹ	mi˧ˀ˥
na	na˧˧
nai	naj˧˧
nam	nam˧˧
nan	nan˧˧
nang	naŋ˧˧
nanh	nɛŋ˧˧
nao	naw˧˧
nat	nat˧˧
nau	năw˧˧
nay	năj˧˧
ne	nɛ˧˧
nem	nɛm˧˧
nen	nɛn˧˧
neo	neo˧˧
neon	neon˧˧
nga	ŋa˧˧
ngai	ŋaj˧˧
ngam	ŋam˧˧
ngan	ŋan˧˧
ngang	ŋaŋ˧˧
nganh	ŋɛŋ˧˧
ngao	ŋaw˧˧
ngau	ŋăw˧˧
ngay	ŋăj˧˧
nghe	ŋɛ˧˧
nghen	ŋɛn˧˧
ngheo	ŋeo˧˧
nghi	ŋi˧˧
nghim	ŋim˧˧
nghinh	ŋiŋ˧˧
nghiu	ŋiw˧˧
nghiêm	ŋiəm˧˧
nghiên	ŋiən˧˧
nghiêng	ŋiəŋ˧˧
nghiêu	ŋiəw˧˧
nghiến	ŋiən˨˦
nghiền	ŋiən˧˨
nghiễm	ŋiəm˧ˀ˥
nghiệm	ŋiəm˨ˀ˩ʔ
nghiện	ŋiən˨ˀ˩ʔ
nghiệp	ŋiəp˨ˀ˩
nghiệt	ŋiət˨ˀ˩
nghè	ŋɛ˧˨
nghèn	ŋɛn˧˨
nghèo	ŋeo˧˨
nghé	ŋɛ˨˦
nghén	ŋɛn˨˦
nghét	ŋɛt˦˥
nghê	ŋe˧˧
nghênh	ŋeŋ˧˧
nghêu	ŋɛu˧˧
nghì	ŋi˧˨
nghìn	ŋin˧˨
nghí	ŋi˨˦
nghía	ŋiə˨˦
nghít	ŋit˦˥
nghĩ	ŋi˧ˀ˥
nghĩa	ŋiə˧ˀ˥
nghĩnh	ŋiŋ˧ˀ˥
nghẹ	ŋɛ˨ˀ˩ʔ
nghẹn	ŋɛn˨ˀ˩ʔ
nghẹo	ŋeo˨ˀ˩ʔ
nghẹt	ŋɛt˨ˀ˩
nghẻn	ŋɛn˧˩˨
nghẻo	ŋeo˧˩˨
nghẽn	ŋɛn˧ˀ˥
nghẽo	ŋeo˧ˀ˥
nghếch	ŋek˦˥
nghến	ŋen˨˦
nghề	ŋe˧˨
nghền	ŋen˧˨
nghềnh	ŋeŋ˧˨
nghều	ŋɛu˧˨
nghể	ŋe˧˩˨
nghển	ŋen˧˩˨
nghểnh	ŋeŋ˧˩˨
nghểu	ŋɛu˧˩˨
nghễ	ŋe˧ˀ˥
nghễnh	ŋeŋ˧ˀ˥
nghễu	ŋɛu˧ˀ˥
nghệ	ŋe˨ˀ˩ʔ
nghệch	ŋek˨ˀ˩
nghện	ŋen˨ˀ˩ʔ
nghệt	ŋet˨ˀ˩
nghệu	ŋɛu˨ˀ˩ʔ
nghỉ	ŋi˧˩˨
nghỉm	ŋim˧˩˨
nghỉn	ŋin˧˩˨
nghỉnh	ŋiŋ˧˩˨
nghỉu	ŋiw˧˩˨
nghị	ŋi˨ˀ˩ʔ
nghịch	ŋik˨ˀ˩
nghịt	ŋit˨ˀ˩
nghịu	ŋiw˨ˀ˩ʔ
ngiệp	ŋep˨ˀ˩
ngo	ŋɔ˧˧
ngoa	ŋwa˧˧
ngoai	ŋwaj˧˧
ngoam	ŋwam˧˧
ngoan	ŋwan˧˧
ngoang	ŋwaŋ˧˧
ngoao	ŋwaw˧˧
ngoay	ŋwăj˧˧
ngoe	ŋwe˧˧
ngoem	ŋwem˧˧
ngoen	ŋwen˧˧
ngoeo	ŋwew˧˧
ngoi	ŋɔj˧˧
ngon	ŋɔn˧˧
ngong	ŋɔŋ͡m˧˧
ngoong	ŋɔɔŋ͡m˧˧
ngoài	ŋwaj˧˨
ngoàm	ŋwam˧˨
ngoác	ŋwak˦˥
ngoách	ŋwɛk˦˥
ngoái	ŋwaj˨˦
ngoáo	ŋwaw˨˦
ngoáp	ŋwap˦˥
ngoáy	ŋwăj˨˦
ngoã	ŋwa˧ˀ˥
ngoãn	ŋwan˧ˀ˥
ngoèo	ŋwew˧˨
ngoé	ŋwe˨˦
ngoém	ŋwem˨˦
ngoén	ŋwen˨˦
ngoéo	ŋwew˨˦
ngoét	ŋwet˦˥
ngoăn	ŋwăn˧˧
ngoăng	ŋwăŋ˧˧
ngoạ	ŋwa˨ˀ˩ʔ
ngoạc	ŋwak˨ˀ˩
ngoạch	ŋwɛk˨ˀ˩
ngoại	ŋwaj˨ˀ˩ʔ
ngoạm	ŋwam˨ˀ˩ʔ
ngoạn	ŋwan˨ˀ˩ʔ
ngoạp	ŋwap˨ˀ˩
ngoạy	ŋwăj˨ˀ˩ʔ
ngoải	ŋwaj˧˩˨
ngoảm	ŋwam˧˩˨
ngoảng	ŋwaŋ˧˩˨
ngoảnh	ŋwɛŋ˧˩˨
ngoảy	ŋwăj˧˩˨
ngoắc	ŋwăk˦˥
ngoắt	ŋwăt˦˥
ngoằn	ŋwăn˧˨
ngoằng	ŋwăŋ˧˨
ngoẳn	ŋwăn˧˩˨
ngoẳng	ŋwăŋ˧˩˨
ngoẵng	ŋwăŋ˧ˀ˥
ngoặc	ŋwăk˨ˀ˩
ngoặt	ŋwăt˨ˀ˩
ngoẹo	ŋwew˨ˀ˩ʔ
ngoẻm	ŋwem˧˩˨
ngoẻn	ŋwen˧˩˨
ngoẻo	ŋwew˧˩˨
ngu	ŋu˧˧
ngun	ŋun˧˧
nguy	ŋwi˧˧
nguyên	ŋwiən˧˧
nguyền	ŋwiən˧˨
nguyễn	ŋwiən˧ˀ˥
nguyện	ŋwiən˨ˀ˩ʔ
nguyệt	ŋwiət˨ˀ˩
nguây	ŋwɤ̆j˧˧
nguôi	ŋuəj˧˧
nguých	ŋwik˦˥
nguýt	ŋwit˦˥
nguầy	ŋwɤ̆j˧˨
nguẩy	ŋwɤ̆j˧˩˨
nguậy	ŋwɤ̆j˨ˀ˩ʔ
nguếch	ŋwek˦˥
nguệch	ŋwek˨ˀ˩
nguồi	ŋuəj˧˨
nguồn	ŋuən˧˨
nguội	ŋuəj˨ˀ˩ʔ
nguỳ	ŋwi˧˨
nguỵ	ŋwi˨ˀ˩ʔ
nguỷu	ŋwiu˧˩˨
ngà	ŋa˧˨
ngài	ŋaj˧˨
ngàm	ŋam˧˨
ngàn	ŋan˧˨
ngàng	ŋaŋ˧˨
ngành	ŋɛŋ˧˨
ngào	ŋaw˧˨
ngàu	ŋăw˧˨
ngày	ŋăj˧˨
ngác	ŋak˦˥
ngách	ŋɛk˦˥
ngái	ŋaj˨˦
ngám	ŋam˨˦
ngán	ŋan˨˦
ngáng	ŋaŋ˨˦
ngánh	ŋɛŋ˨˦
ngáo	ŋaw˨˦
ngáp	ŋap˦˥
ngát	ŋat˦˥
ngáu	ŋăw˨˦
ngáy	ŋăj˨˦
ngâm	ŋɤ̆m˧˧
ngân	ŋɤ̆n˧˧
ngâu	ŋɤ̆w˧˧
ngây	ŋɤ̆j˧˧
ngã	ŋa˧ˀ˥
ngãi	ŋaj˧ˀ˥
ngãng	ŋaŋ˧ˀ˥
ngão	ŋaw˧ˀ˥
ngía	ŋiə˨˦
ngò	ŋɔ˧˨
ngòi	ŋɔj˧˨
ngòm	ŋɔm˧˨
ngòn	ŋɔn˧˨
ngòng	ŋɔŋ͡m˧˨
ngó	ŋɔ˨˦
ngóc	ŋɔk͡p˦˥
ngóe	ŋwe˨˦
ngóeo	ŋwew˨˦
ngói	ŋɔj˨˦
ngóm	ŋɔm˨˦
ngón	ŋɔn˨˦
ngóng	ŋɔŋ͡m˨˦
ngóp	ŋɔp˦˥
ngót	ŋɔt˦˥
ngô	ŋo˧˧
ngôi	ŋoj˧˧
ngôn	ŋon˧˧
ngông	ŋoŋ͡m˧˧
ngõ	ŋɔ˧ˀ˥
ngõa	ŋwa˧ˀ˥
ngõi	ŋɔj˧ˀ˥
ngõng	ŋɔŋ͡m˧ˀ˥
ngù	ŋu˧˨
ngùi	ŋuj˧˨
ngùn	ŋun˧˨
ngùng	ŋuŋ͡m˧˨
ngú	ŋu˨˦
ngúc	ŋuk͡p˦˥
ngún	ŋun˨˦
ngúng	ŋuŋ͡m˨˦
ngút	ŋut˦˥
ngăm	ŋăm˧˧
ngăn	ŋăn˧˧
ngũ	ŋu˧ˀ˥
ngũn	ŋun˧ˀ˥
ngũng	ŋuŋ͡m˧ˀ˥
ngơ	ŋɤ˧˧
ngơi	ŋɤj˧˧
ngơm	ŋɤm˧˧
ngơn	ŋɤn˧˧
ngư	ŋɯ˧˧
ngưa	ŋɯə˧˧
ngưng	ŋɯŋ˧˧
ngưu	ŋɯw˧˧
ngươi	ŋɯəj˧˧
ngươn	ŋɯən˧˧
ngước	ŋɯək˦˥
ngườ	ŋɯə˧˨
người	ŋɯəj˧˨
ngường	ŋɯəŋ˧˨
ngưởng	ŋɯəŋ˧˩˨
ngưỡng	ŋɯəŋ˧ˀ˥
ngược	ŋɯək˨ˀ˩
ngượng	ŋɯəŋ˨ˀ˩ʔ
ngạc	ŋak˨ˀ˩
ngạch	ŋɛk˨ˀ˩
ngại	ŋaj˨ˀ˩ʔ
ngạn	ŋan˨ˀ˩ʔ
ngạnh	ŋɛŋ˨ˀ˩ʔ
ngạo	ŋaw˨ˀ˩ʔ
ngạt	ŋat˨ˀ˩
ngả	ŋa˧˩˨
ngải	ŋaj˧˩˨
ngảng	ŋaŋ˧˩˨
ngảnh	ŋɛŋ˧˩˨
ngảo	ŋaw˧˩˨
ngấc	ŋɤ̆k˦˥
ngấm	ŋɤ̆m˨˦
ngấn	ŋɤ̆n˨˦
ngấp	ŋɤ̆p˦˥
ngất	ŋɤ̆t˦˥
ngấu	ŋɤ̆w˨˦
ngấy	ŋɤ̆j˨˦
ngầm	ŋɤ̆m˧˨
ngần	ŋɤ̆n˧˨
ngầu	ŋɤ̆w˧˨
ngầy	ŋɤ̆j˧˨
ngẩm	ŋɤ̆m˧˩˨
ngẩn	ŋɤ̆n˧˩˨
ngẩng	ŋɤ̆ŋ˧˩˨
ngẫm	ŋɤ̆m˧ˀ˥
ngẫn	ŋɤ̆n˧ˀ˥
ngẫu	ŋɤ̆w˧ˀ˥
ngậm	ŋɤ̆m˨ˀ˩ʔ
ngận	ŋɤ̆n˨ˀ˩ʔ
ngập	ŋɤ̆p˨ˀ˩
ngật	ŋɤ̆t˨ˀ˩
ngậu	ŋɤ̆w˨ˀ˩ʔ
ngậy	ŋɤ̆j˨ˀ˩ʔ
ngắc	ŋăk˦˥
ngắm	ŋăm˨˦
ngắn	ŋăn˨˦
ngắt	ŋăt˦˥
ngằn	ŋăn˧˨
ngẳn	ŋăn˧˩˨
ngẳng	ŋăŋ˧˩˨
ngẵng	ŋăŋ˧ˀ˥
ngặt	ŋăt˨ˀ˩
ngẹt	ŋɛt˨ˀ˩
ngịu	ŋiw˨ˀ˩ʔ
ngọ	ŋɔ˨ˀ˩ʔ
ngọc	ŋɔk͡p˨ˀ˩
ngọn	ŋɔn˨ˀ˩ʔ
ngọng	ŋɔŋ͡m˨ˀ˩ʔ
ngọt	ŋɔt˨ˀ˩
ngỏ	ŋɔ˧˩˨
ngỏm	ŋɔm˧˩˨
ngỏn	ŋɔn˧˩˨
ngỏng	ŋɔŋ͡m˧˩˨
ngố	ŋo˨˦
ngốc	ŋok͡p˦˥
ngốn	ŋon˨˦
ngốt	ŋot˦˥
ngồ	ŋo˧˨
ngồi	ŋoj˧˨
ngồm	ŋom˧˨
ngồn	ŋon˧˨
ngồng	ŋoŋ͡m˧˨
ngổ	ŋo˧˩˨
ngổm	ŋom˧˩˨
ngổn	ŋon˧˩˨
ngổng	ŋoŋ͡m˧˩˨
ngỗ	ŋo˧ˀ˥
ngỗi	ŋoj˧ˀ˥
ngỗng	ŋoŋ͡m˧ˀ˥
ngộ	ŋo˨ˀ˩ʔ
ngộc	ŋok͡p˨ˀ˩
ngộn	ŋon˨ˀ˩ʔ
ngộp	ŋop˨ˀ˩
ngột	ŋot˨ˀ˩
ngớ	ŋɤ˨˦
ngớn	ŋɤn˨˦
ngớp	ŋɤp˦˥
ngớt	ŋɤt˦˥
ngờ	ŋɤ˧˨
ngời	ŋɤj˧˨
ngờm	ŋɤm˧˨
ngởn	ŋɤn˧˩˨
ngỡ	ŋɤ˧ˀ˥
ngỡi	ŋɤj˧ˀ˥
ngỡn	ŋɤn˧ˀ˥
ngợ	ŋɤ˨ˀ˩ʔ
ngợi	ŋɤj˨ˀ˩ʔ
ngợm	ŋɤm˨ˀ˩ʔ
ngợp	ŋɤp˨ˀ˩
ngụ	ŋu˨ˀ˩ʔ
ngụa	ŋuə˨ˀ˩ʔ
ngục	ŋuk͡p˨ˀ˩
ngụm	ŋum˨ˀ˩ʔ
ngụp	ŋup˨ˀ˩
ngụt	ŋut˨ˀ˩
ngụy	ŋwi˨ˀ˩ʔ
ngủ	ŋu˧˩˨
ngủi	ŋuj˧˩˨
ngủm	ŋum˧˩˨
ngủn	ŋun˧˩˨
ngủng	ŋuŋ͡m˧˩˨
ngứ	ŋɯ˨˦
ngứa	ŋɯə˨˦
ngứng	ŋɯŋ˨˦
ngứt	ŋɯt˦˥
ngừ	ŋɯ˧˨
ngừa	ŋɯə˧˨
ngừng	ŋɯŋ˧˨
ngửa	ŋɯə˧˩˨
ngửi	ŋɯj˧˩˨
ngửng	ŋɯŋ˧˩˨
ngữ	ŋɯ˧ˀ˥
ngự	ŋɯ˨ˀ˩ʔ
ngựa	ŋɯə˨ˀ˩ʔ
ngực	ŋɯk˨ˀ˩
nha	ɲa˧˧
nhai	ɲaj˧˧
nham	ɲam˧˧
nhan	ɲan˧˧
nhang	ɲaŋ˧˧
nhanh	ɲɛŋ˧˧
nhao	ɲaw˧˧
nhau	ɲăw˧˧
nhay	ɲăj˧˧
nhe	ɲɛ˧˧
nhem	ɲɛm˧˧
nhen	ɲɛn˧˧
nheo	ɲeo˧˧
nhi	ɲi˧˧
nhinh	ɲiŋ˧˧
nhiu	ɲiw˧˧
nhiên	ɲiən˧˧
nhiêu	ɲiəw˧˧
nhiếc	ɲiək˦˥
nhiếp	ɲiəp˦˥
nhiều	ɲiəw˧˨
nhiễm	ɲiəm˧ˀ˥
nhiễn	ɲiən˧ˀ˥
nhiễu	ɲiəw˧ˀ˥
nhiệm	ɲiəm˨ˀ˩ʔ
nhiệt	ɲiət˨ˀ˩
nho	ɲɔ˧˧
nhoai	ɲwaj˧˧
nhoang	ɲwaŋ˧˧
nhoay	ɲwăj˧˧
nhoe	ɲwe˧˧
nhoen	ɲwen˧˧
nhoi	ɲɔj˧˧
nhom	ɲɔm˧˧
nhon	ɲɔn˧˧
nhong	ɲɔŋ͡m˧˧
nhoà	ɲwa˧˨
nhoài	ɲwaj˧˨
nhoàm	ɲwam˧˨
nhoàng	ɲwaŋ˧˨
nhoá	ɲwa˨˦
nhoáng	ɲwaŋ˨˦
nhoáy	ɲwăj˨˦
nhoè	ɲwe˧˨
nhoèn	ɲwen˧˨
nhoé	ɲwe˨˦
nhoét	ɲwet˦˥
nhoạng	ɲwaŋ˨ˀ˩ʔ
nhoằng	ɲwăŋ˧˨
nhoẹt	ɲwet˨ˀ˩
nhoẻn	ɲwen˧˩˨
nhu	ɲu˧˧
nhui	ɲuj˧˧
nhum	ɲum˧˧
nhun	ɲun˧˧
nhung	ɲuŋ͡m˧˧
nhuyễn	ɲwiən˧ˀ˥
nhuôm	ɲuəm˧˧
nhuần	ɲwɤ̆n˧˨
nhuận	ɲwɤ̆n˨ˀ˩ʔ
nhuế	ɲwe˨˦
nhuệ	ɲwe˨ˀ˩ʔ
nhuốc	ɲuək˦˥
nhuốm	ɲuəm˨˦
nhuồn	ɲuən˧˨
nhuộm	ɲuəm˨ˀ˩ʔ
nhuỵ	ɲwi˨ˀ˩ʔ
nhà	ɲa˧˨
nhài	ɲaj˧˨
nhàm	ɲam˧˨
nhàn	ɲan˧˨
nhàng	ɲaŋ˧˨
nhành	ɲɛŋ˧˨
nhào	ɲaw˧˨
nhàu	ɲăw˧˨
nhày	ɲăj˧˨
nhá	ɲa˨˦
nhác	ɲak˦˥
nhách	ɲɛk˦˥
nhái	ɲaj˨˦
nhám	ɲam˨˦
nháng	ɲaŋ˨˦
nhánh	ɲɛŋ˨˦
nháo	ɲaw˨˦
nháp	ɲap˦˥
nhát	ɲat˦˥
nháu	ɲăw˨˦
nháy	ɲăj˨˦
nhâm	ɲɤ̆m˧˧
nhân	ɲɤ̆n˧˧
nhâng	ɲɤ̆ŋ˧˧
nhâu	ɲɤ̆w˧˧
nhây	ɲɤ̆j˧˧
nhã	ɲa˧ˀ˥
nhãi	ɲaj˧ˀ˥
nhãn	ɲan˧ˀ˥
nhãng	ɲaŋ˧ˀ˥
nhão	ɲaw˧ˀ˥
nhè	ɲɛ˧˨
nhèm	ɲɛm˧˨
nhèn	ɲɛn˧˨
nhèo	ɲeo˧˨
nhé	ɲɛ˨˦
nhém	ɲɛm˨˦
nhén	ɲɛn˨˦
nhéo	ɲeo˨˦
nhép	ɲɛp˦˥
nhét	ɲɛt˦˥
nhê	ɲe˧˧
nhênh	ɲeŋ˧˧
nhì	ɲi˧˨
nhìn	ɲin˧˨
nhìu	ɲiw˧˨
nhí	ɲi˨˦
nhía	ɲiə˨˦
nhích	ɲik˦˥
nhím	ɲim˨˦
nhín	ɲin˨˦
nhính	ɲiŋ˨˦
nhíp	ɲip˦˥
nhít	ɲit˦˥
nhíu	ɲiw˨˦
nhò	ɲɔ˧˨
nhòa	ɲwa˧˨
nhòe	ɲwe˧˨
nhòm	ɲɔm˧˨
nhòng	ɲɔŋ͡m˧˨
nhó	ɲɔ˨˦
nhóa	ɲwa˨˦
nhóc	ɲɔk͡p˦˥
nhóe	ɲwe˨˦
nhói	ɲɔj˨˦
nhóm	ɲɔm˨˦
nhón	ɲɔn˨˦
nhóng	ɲɔŋ͡m˨˦
nhóp	ɲɔp˦˥
nhót	ɲɔt˦˥
nhô	ɲo˧˧
nhôi	ɲoj˧˧
nhôm	ɲom˧˧
nhôn	ɲon˧˧
nhông	ɲoŋ͡m˧˧
nhõ	ɲɔ˧ˀ˥
nhõi	ɲɔj˧ˀ˥
nhõm	ɲɔm˧ˀ˥
nhõn	ɲɔn˧ˀ˥
nhõng	ɲɔŋ͡m˧ˀ˥
nhù	ɲu˧˨
nhùi	ɲuj˧˨
nhùn	ɲun˧˨
nhùng	ɲuŋ͡m˧˨
nhú	ɲu˨˦
nhúa	ɲuə˨˦
nhúc	ɲuk͡p˦˥
nhúi	ɲuj˨˦
nhúm	ɲum˨˦
nhún	ɲun˨˦
nhúng	ɲuŋ͡m˨˦
nhút	ɲut˦˥
nhăm	ɲăm˧˧
nhăn	ɲăn˧˧
nhăng	ɲăŋ˧˧
nhĩ	ɲi˧ˀ˥
nhũ	ɲu˧ˀ˥
nhũn	ɲun˧ˀ˥
nhũng	ɲuŋ͡m˧ˀ˥
nhơ	ɲɤ˧˧
nhơi	ɲɤj˧˧
nhơm	ɲɤm˧˧
nhơn	ɲɤn˧˧
như	ɲɯ˧˧
nhưng	ɲɯŋ˧˧
nhương	ɲɯəŋ˧˧
nhướn	ɲɯən˨˦
nhướng	ɲɯəŋ˨˦
nhường	ɲɯəŋ˧˨
nhưỡng	ɲɯəŋ˧ˀ˥
nhược	ɲɯək˨ˀ˩
nhượng	ɲɯəŋ˨ˀ˩ʔ
nhạc	ɲak˨ˀ˩
nhại	ɲaj˨ˀ˩ʔ
nhạn	ɲan˨ˀ˩ʔ
nhạng	ɲaŋ˨ˀ˩ʔ
nhạnh	ɲɛŋ˨ˀ˩ʔ
nhạo	ɲaw˨ˀ˩ʔ
nhạp	ɲap˨ˀ˩
nhạt	ɲat˨ˀ˩
nhạy	ɲăj˨ˀ˩ʔ
nhả	ɲa˧˩˨
nhải	ɲaj˧˩˨
nhảm	ɲam˧˩˨
nhản	ɲan˧˩˨
nhảnh	ɲɛŋ˧˩˨
nhảo	ɲaw˧˩˨
nhảu	ɲăw˧˩˨
nhảy	ɲăj˧˩˨
nhấc	ɲɤ̆k˦˥
nhấm	ɲɤ̆m˨˦
nhấn	ɲɤ̆n˨˦
nhấp	ɲɤ̆p˦˥
nhất	ɲɤ̆t˦˥
nhấy	ɲɤ̆j˨˦
nhầm	ɲɤ̆m˧˨
nhần	ɲɤ̆n˧˨
nhầu	ɲɤ̆w˧˨
nhầy	ɲɤ̆j˧˨
nhẩm	ɲɤ̆m˧˩˨
nhẩn	ɲɤ̆n˧˩˨
nhẩu	ɲɤ̆w˧˩˨
nhẩy	ɲɤ̆j˧˩˨
nhẫm	ɲɤ̆m˧ˀ˥
nhẫn	ɲɤ̆n˧ˀ˥
nhẫy	ɲɤ̆j˧ˀ˥
nhậm	ɲɤ̆m˨ˀ˩ʔ
nhận	ɲɤ̆n˨ˀ˩ʔ
nhập	ɲɤ̆p˨ˀ˩
nhật	ɲɤ̆t˨ˀ˩
nhậu	ɲɤ̆w˨ˀ˩ʔ
nhậy	ɲɤ̆j˨ˀ˩ʔ
nhắc	ɲăk˦˥
nhắm	ɲăm˨˦
nhắn	ɲăn˨˦
nhắng	ɲăŋ˨˦
nhắp	ɲăp˦˥
nhắt	ɲăt˦˥
nhằm	ɲăm˧˨
nhằn	ɲăn˧˨
nhằng	ɲăŋ˧˨
nhẳn	ɲăn˧˩˨
nhẳng	ɲăŋ˧˩˨
nhẵn	ɲăn˧ˀ˥
nhẵng	ɲăŋ˧ˀ˥
nhặm	ɲăm˨ˀ˩ʔ
nhặn	ɲăn˨ˀ˩ʔ
nhặng	ɲăŋ˨ˀ˩ʔ
nhặt	ɲăt˨ˀ˩
nhẹ	ɲɛ˨ˀ˩ʔ
nhẹm	ɲɛm˨ˀ˩ʔ
nhẹn	ɲɛn˨ˀ˩ʔ
nhẹo	ɲeo˨ˀ˩ʔ
nhẹp	ɲɛp˨ˀ˩
nhẹt	ɲɛt˨ˀ˩
nhẻ	ɲɛ˧˩˨
nhẻm	ɲɛm˧˩˨
nhẻo	ɲeo˧˩˨
nhẽ	ɲɛ˧ˀ˥
nhẽo	ɲeo˧ˀ˥
nhếch	ɲek˦˥
nhếu	ɲɛu˨˦
nhều	ɲɛu˧˨
nhể	ɲe˧˩˨
nhểu	ɲɛu˧˩˨
nhễ	ɲe˧ˀ˥
nhệch	ɲek˨ˀ˩
nhện	ɲen˨ˀ˩ʔ
nhệu	ɲɛu˨ˀ˩ʔ
nhỉ	ɲi˧˩˨
nhỉnh	ɲiŋ˧˩˨
nhỉu	ɲiw˧˩˨
nhị	ɲi˨ˀ˩ʔ
nhịn	ɲin˨ˀ˩ʔ
nhịp	ɲip˨ˀ˩
nhịt	ɲit˨ˀ˩
nhịu	ɲiw˨ˀ˩ʔ
nhọ	ɲɔ˨ˀ˩ʔ
nhọc	ɲɔk͡p˨ˀ˩
nhọn	ɲɔn˨ˀ˩ʔ
nhọt	ɲɔt˨ˀ˩
nhỏ	ɲɔ˧˩˨
nhỏm	ɲɔm˧˩˨
nhỏn	ɲɔn˧˩˨
nhỏng	ɲɔŋ͡m˧˩˨
nhố	ɲo˨˦
nhốc	ɲok͡p˦˥
nhối	ɲoj˨˦
nhốn	ɲon˨˦
nhốp	ɲop˦˥
nhốt	ɲot˦˥
nhồi	ɲoj˧˨
nhồm	ɲom˧˨
nhồn	ɲon˧˨
nhồng	ɲoŋ͡m˧˨
nhổ	ɲo˧˩˨
nhổm	ɲom˧˩˨
nhổn	ɲon˧˩˨
nhổng	ɲoŋ͡m˧˩˨
nhội	ɲoj˨ˀ˩ʔ
nhộn	ɲon˨ˀ˩ʔ
nhộng	ɲoŋ͡m˨ˀ˩ʔ
nhột	ɲot˨ˀ˩
nhớ	ɲɤ˨˦
nhớm	ɲɤm˨˦
nhớn	ɲɤn˨˦
nhớp	ɲɤp˦˥
nhớt	ɲɤt˦˥
nhờ	ɲɤ˧˨
nhời	ɲɤj˧˨
nhờm	ɲɤm˧˨
nhờn	ɲɤn˧˨
nhở	ɲɤ˧˩˨
nhởi	ɲɤj˧˩˨
nhởn	ɲɤn˧˩˨
nhỡ	ɲɤ˧ˀ˥
nhỡn	ɲɤn˧ˀ˥
nhợ	ɲɤ˨ˀ˩ʔ
nhợn	ɲɤn˨ˀ˩ʔ
nhợp	ɲɤp˨ˀ˩
nhợt	ɲɤt˨ˀ˩
nhụ	ɲu˨ˀ˩ʔ
nhụa	ɲuə˨ˀ˩ʔ
nhục	ɲuk͡p˨ˀ˩
nhụi	ɲuj˨ˀ˩ʔ
nhụng	ɲuŋ͡m˨ˀ˩ʔ
nhụt	ɲut˨ˀ˩
nhụy	ɲwi˨ˀ˩ʔ
nhủ	ɲu˧˩˨
nhủi	ɲuj˧˩˨
nhủn	ɲun˧˩˨
nhủng	ɲuŋ͡m˧˩˨
nhứ	ɲɯ˨˦
nhức	ɲɯk˦˥
nhứt	ɲɯt˦˥
nhừ	ɲɯ˧˨
nhử	ɲɯ˧˩˨
nhửng	ɲɯŋ˧˩˨
nhữ	ɲɯ˧ˀ˥
những	ɲɯŋ˧ˀ˥
nhự	ɲɯ˨ˀ˩ʔ
nhựa	ɲɯə˨ˀ˩ʔ
nhựt	ɲɯt˨ˀ˩
ni	ni˧˧
nia	niə˧˧
nic	nik˧˧
nin	nin˧˧
ninh	niŋ˧˧
nit	nit˧˧
niu	niw˧˧
niêm	niəm˧˧
niên	niən˧˧
niêu	niəw˧˧
niết	niət˦˥
niềm	niəm˧˨
niền	niən˧˨
niềng	niəŋ˧˨
niễng	niəŋ˧ˀ˥
niệm	niəm˨ˀ˩ʔ
niệt	niət˨ˀ˩
niệu	niəw˨ˀ˩ʔ
no	nɔ˧˧
noa	nwa˧˧
noi	nɔj˧˧
nom	nɔm˧˧
non	nɔn˧˧
nong	nɔŋ͡m˧˧
noong	nɔɔŋ͡m˧˧
noãn	nwan˧ˀ˥
nu	nu˧˧
nua	nuə˧˧
nui	nuj˧˧
num	num˧˧
nung	nuŋ͡m˧˧
nuy	nwi˧˧
nuôi	nuəj˧˧
nuông	nuəŋ˧˧
nuốc	nuək˦˥
nuối	nuəj˨˦
nuốm	nuəm˨˦
nuốt	nuət˦˥
nuộc	nuək˨ˀ˩
nuột	nuət˨ˀ˩
nà	na˧˨
nài	naj˧˨
nàn	nan˧˨
nàng	naŋ˧˨
nành	nɛŋ˧˨
nào	naw˧˨
này	năj˧˨
ná	na˨˦
nác	nak˦˥
nách	nɛk˦˥
nái	naj˨˦
nám	nam˨˦
nán	nan˨˦
náng	naŋ˨˦
nánh	nɛŋ˨˦
náo	naw˨˦
náp	nap˦˥
nát	nat˦˥
náu	năw˨˦
náy	năj˨˦
nâm	nɤ̆m˧˧
nân	nɤ̆n˧˧
nâng	nɤ̆ŋ˧˧
nâu	nɤ̆w˧˧
nây	nɤ̆j˧˧
nã	na˧ˀ˥
não	naw˧ˀ˥
nãy	năj˧ˀ˥
nè	nɛ˧˨
nèo	neo˧˨
né	nɛ˨˦
ném	nɛm˨˦
nén	nɛn˨˦
néo	neo˨˦
nép	nɛp˦˥
nét	nɛt˦˥
nê	ne˧˧
nêm	nem˧˧
nên	nen˧˧
nênh	neŋ˧˧
nêu	nɛu˧˧
nì	ni˧˨
nình	niŋ˧˨
ní	ni˨˦
níc	nik˦˥
ních	nik˦˥
nín	nin˨˦
nính	niŋ˨˦
níp	nip˦˥
nít	nit˦˥
níu	niw˨˦
nò	nɔ˧˨
nòi	nɔj˧˨
nòm	nɔm˧˨
nòng	nɔŋ͡m˧˨
nó	nɔ˨˦
nóc	nɔk͡p˦˥
nói	nɔj˨˦
nón	nɔn˨˦
nóng	nɔŋ͡m˨˦
nóp	nɔp˦˥
nót	nɔt˦˥
nô	no˧˧
nôi	noj˧˧
nôm	nom˧˧
nôn	non˧˧
nông	noŋ͡m˧˧
nõ	nɔ˧ˀ˥
nõn	nɔn˧ˀ˥
nùi	nuj˧˨
nùn	nun˧˨
nùng	nuŋ͡m˧˨
nú	nu˨˦
núa	nuə˨˦
núc	nuk͡p˦˥
núi	nuj˨˦
núm	num˨˦
núng	nuŋ͡m˨˦
núp	nup˦˥
nút	nut˦˥
năm	năm˧˧
năn	năn˧˧
năng	năŋ˧˧
nĩa	niə˧ˀ˥
nũng	nuŋ͡m˧ˀ˥
nơ	nɤ˧˧
nơi	nɤj˧˧
nơm	nɤm˧˧
nư	nɯ˧˧
nưa	nɯə˧˧
nưng	nɯŋ˧˧
nương	nɯəŋ˧˧
nước	nɯək˦˥
nướng	nɯəŋ˨˦
nườm	nɯəm˧˨
nường	nɯəŋ˧˨
nược	nɯək˨ˀ˩
nượp	nɯəp˨ˀ˩
nạ	na˨ˀ˩ʔ
nạc	nak˨ˀ˩
nại	naj˨ˀ˩ʔ
nạm	nam˨ˀ˩ʔ
nạn	nan˨ˀ˩ʔ
nạng	naŋ˨ˀ˩ʔ
nạnh	nɛŋ˨ˀ˩ʔ
nạo	naw˨ˀ˩ʔ
nạp	nap˨ˀ˩
nạt	nat˨ˀ˩
nạy	năj˨ˀ˩ʔ
nả	na˧˩˨
nải	naj˧˩˨
nản	nan˧˩˨
nảo	naw˧˩˨
nảy	năj˧˩˨
nấc	nɤ̆k˦˥
nấm	nɤ̆m˨˦
nấn	nɤ̆n˨˦
nấng	nɤ̆ŋ˨˦
nấp	nɤ̆p˦˥
nấu	nɤ̆w˨˦
nấy	nɤ̆j˨˦
nầm	nɤ̆m˧˨
nần	nɤ̆n˧˨
nầy	nɤ̆j˧˨
nẩy	nɤ̆j˧˩˨
nẫm	nɤ̆m˧ˀ˥
nẫn	nɤ̆n˧ˀ˥
nẫng	nɤ̆ŋ˧ˀ˥
nẫu	nɤ̆w˧ˀ˥
nẫy	nɤ̆j˧ˀ˥
nậm	nɤ̆m˨ˀ˩ʔ
nậng	nɤ̆ŋ˨ˀ˩ʔ
nập	nɤ̆p˨ˀ˩
nậu	nɤ̆w˨ˀ˩ʔ
nậy	nɤ̆j˨ˀ˩ʔ
nắc	năk˦˥
nắm	năm˨˦
nắn	năn˨˦
nắng	năŋ˨˦
nắp	năp˦˥
nằm	năm˧˨
nằn	năn˧˨
nằng	năŋ˧˨
nẵng	năŋ˧ˀ˥
nặc	năk˨ˀ˩
nặn	năn˨ˀ˩ʔ
nặng	năŋ˨ˀ˩ʔ
nẹ	nɛ˨ˀ˩ʔ
nẹp	nɛp˨ˀ˩
nẹt	nɛt˨ˀ˩
nẻ	nɛ˧˩˨
nẻo	neo˧˩˨
nếm	nem˨˦
nến	nen˨˦
nếp	nep˦˥
nết	net˦˥
nếu	nɛu˨˦
nề	ne˧˨
nền	nen˧˨
nể	ne˧˩˨
nệ	ne˨ˀ˩ʔ
nệm	nem˨ˀ˩ʔ
nện	nen˨ˀ˩ʔ
nệp	nep˨ˀ˩
nỉ	ni˧˩˨
nị	ni˨ˀ˩ʔ
nịch	nik˨ˀ˩
nịnh	niŋ˨ˀ˩ʔ
nịt	nit˨ˀ˩
nịu	niw˨ˀ˩ʔ
nọ	nɔ˨ˀ˩ʔ
nọc	nɔk͡p˨ˀ˩
nọi	nɔj˨ˀ˩ʔ
nọn	nɔn˨ˀ˩ʔ
nọng	nɔŋ͡m˨ˀ˩ʔ
nọt	nɔt˨ˀ˩
nỏ	nɔ˧˩˨
nỏi	nɔj˧˩˨
nỏm	nɔm˧˩˨
nố	no˨˦
nốc	nok͡p˦˥
nối	noj˨˦
nống	noŋ͡m˨˦
nốp	nop˦˥
nốt	not˦˥
nồ	no˧˨
nồi	noj˧˨
nồm	nom˧˨
nồng	noŋ͡m˧˨
nổ	no˧˩˨
nổi	noj˧˩˨
nổng	noŋ͡m˧˩˨
nỗ	no˧ˀ˥
nỗi	noj˧ˀ˥
nỗng	noŋ͡m˧ˀ˥
nộ	no˨ˀ˩ʔ
nội	noj˨ˀ˩ʔ
nộm	nom˨ˀ˩ʔ
nộn	non˨ˀ˩ʔ
nộp	nop˨ˀ˩
nột	not˨ˀ˩
nớ	nɤ˨˦
nới	nɤj˨˦
nớp	nɤp˦˥
nớt	nɤt˦˥
nờ	nɤ˧˨
nờm	nɤm˧˨
nở	nɤ˧˩˨
nỡ	nɤ˧ˀ˥
nỡm	nɤm˧ˀ˥
nợ	nɤ˨ˀ˩ʔ
nợp	nɤp˨ˀ˩
nụ	nu˨ˀ˩ʔ
nục	nuk͡p˨ˀ˩
nủa	nuə˧˩˨
nứa	nɯə˨˦
nức	nɯk˦˥
nứng	nɯŋ˨˦
nứt	nɯt˦˥
nừng	nɯŋ˧˨
nử	nɯ˧˩˨
nửa	nɯə˧˩˨
nữ	nɯ˧ˀ˥
nữa	nɯə˧ˀ˥
nự	nɯ˨ˀ˩ʔ
nực	nɯk˨ˀ˩
nựng	nɯŋ˨ˀ˩ʔ
o	ɔ˧˧
oa	wa˧˧
oai	waj˧˧
oan	wan˧˧
oang	waŋ˧˧
oanh	wɛŋ˧˧
oe	we˧˧
oeng	weŋ˧˧
oeo	wew˧˧
oi	ɔj˧˧
om	ɔm˧˧
on	ɔn˧˧
ong	ɔŋ͡m˧˧
oong	ɔɔŋ͡m˧˧
oà	wa˧˨
oài	waj˧˨
oàm	wam˧˨
oàng	waŋ˧˨
oành	wɛŋ˧˨
oác	wak˦˥
oách	wɛk˦˥
oái	waj˨˦
oán	wan˨˦
oánh	wɛŋ˨˦
oáp	wap˦˥
oát	wat˦˥
oèo	wew˧˨
oé	we˨˦
oéc	wek˦˥
oóc	ɔɔk͡p˦˥
oăm	wăm˧˧
oăn	wăn˧˧
oăng	wăŋ˧˧
oạc	wak˨ˀ˩
oạch	wɛk˨ˀ˩
oại	waj˨ˀ˩ʔ
oạp	wap˨ˀ˩
oải	waj˧˩˨
oản	wan˧˩˨
oắt	wăt˦˥
oằn	wăn˧˨
oẳn	wăn˧˩˨
oẳng	wăŋ˧˩˨
oặt	wăt˨ˀ˩
oẹ	we˨ˀ˩ʔ
oẻ	we˧˩˨
pa	pa˧˧
pai	paj˧˧
pan	pan˧˧
pang	paŋ˧˧
panh	pɛŋ˧˧
pao	paw˧˧
pe	pɛ˧˧
pen	pɛn˧˧
pha	fa˧˧
phai	faj˧˧
phan	fan˧˧
phang	faŋ˧˧
phanh	fɛŋ˧˧
phao	faw˧˧
phau	făw˧˧
phay	făj˧˧
phe	fɛ˧˧
phen	fɛn˧˧
pheo	feo˧˧
phi	fi˧˧
phia	fiə˧˧
phim	fim˧˧
phin	fin˧˧
phinh	fiŋ˧˧
phiu	fiw˧˧
phiên	fiən˧˧
phiêu	fiəw˧˧
phiếm	fiəm˨˦
phiến	fiən˨˦
phiết	fiət˦˥
phiếu	fiəw˨˦
phiền	fiən˧˨
phiện	fiən˨ˀ˩ʔ
phiệt	fiət˨ˀ˩
phiệu	fiəw˨ˀ˩ʔ
pho	fɔ˧˧
phoi	fɔj˧˧
phom	fɔm˧˧
phon	fɔn˧˧
phong	fɔŋ͡m˧˧
phoóc	fɔɔk͡p˦˥
phu	fu˧˧
phua	fuə˧˧
phui	fuj˧˧
phun	fun˧˧
phung	fuŋ͡m˧˧
phuy	fwi˧˧
phà	fa˧˨
phài	faj˧˨
phàm	fam˧˨
phàn	fan˧˨
phàng	faŋ˧˨
phành	fɛŋ˧˨
phào	faw˧˨
phá	fa˨˦
phác	fak˦˥
phách	fɛk˦˥
phái	faj˨˦
phán	fan˨˦
pháo	faw˨˦
pháp	fap˦˥
phát	fat˦˥
pháy	făj˨˦
phân	fɤ̆n˧˧
phây	fɤ̆j˧˧
phè	fɛ˧˨
phèn	fɛn˧˨
phèng	fɛŋ˧˨
phèo	feo˧˨
phé	fɛ˨˦
phéc	fɛk˦˥
phéng	fɛŋ˨˦
phép	fɛp˦˥
phét	fɛt˦˥
phê	fe˧˧
phên	fen˧˧
phênh	feŋ˧˧
phêu	fɛu˧˧
phì	fi˧˨
phìa	fiə˧˨
phìn	fin˧˨
phình	fiŋ˧˨
phí	fi˨˦
phía	fiə˨˦
phích	fik˦˥
phím	fim˨˦
phính	fiŋ˨˦
phít	fit˦˥
phò	fɔ˧˨
phòi	fɔj˧˨
phòm	fɔm˧˨
phòng	fɔŋ͡m˧˨
phó	fɔ˨˦
phóc	fɔk͡p˦˥
phóng	fɔŋ͡m˨˦
phót	fɔt˦˥
phô	fo˧˧
phôi	foj˧˧
phôm	fom˧˧
phôn	fon˧˧
phông	foŋ͡m˧˧
phù	fu˧˨
phùa	fuə˧˨
phùn	fun˧˨
phùng	fuŋ͡m˧˨
phú	fu˨˦
phúc	fuk͡p˦˥
phún	fun˨˦
phúng	fuŋ͡m˨˦
phút	fut˦˥
phăm	făm˧˧
phăn	făn˧˧
phăng	făŋ˧˧
phĩnh	fiŋ˧ˀ˥
phũ	fu˧ˀ˥
phơ	fɤ˧˧
phơi	fɤj˧˧
phơn	fɤn˧˧
phưng	fɯŋ˧˧
phương	fɯəŋ˧˧
phước	fɯək˦˥
phướn	fɯən˨˦
phướng	fɯəŋ˨˦
phường	fɯəŋ˧˨
phưỡn	fɯən˧ˀ˥
phược	fɯək˨ˀ˩
phượng	fɯəŋ˨ˀ˩ʔ
phượu	fɯəw˨ˀ˩ʔ
phạ	fa˨ˀ˩ʔ
phạc	fak˨ˀ˩
phạch	fɛk˨ˀ˩
phạm	fam˨ˀ˩ʔ
phạn	fan˨ˀ˩ʔ
phạng	faŋ˨ˀ˩ʔ
phạo	faw˨ˀ˩ʔ
phạt	fat˨ˀ˩
phả	fa˧˩˨
phải	faj˧˩˨
phản	fan˧˩˨
phảng	faŋ˧˩˨
phảy	făj˧˩˨
phấn	fɤ̆n˨˦
phấp	fɤ̆p˦˥
phất	fɤ̆t˦˥
phầm	fɤ̆m˧˨
phần	fɤ̆n˧˨
phẩm	fɤ̆m˧˩˨
phẩn	fɤ̆n˧˩˨
phẩy	fɤ̆j˧˩˨
phẫn	fɤ̆n˧ˀ˥
phẫu	fɤ̆w˧ˀ˥
phận	fɤ̆n˨ˀ˩ʔ
phập	fɤ̆p˨ˀ˩
phật	fɤ̆t˨ˀ˩
phắc	făk˦˥
phắn	făn˨˦
phắp	făp˦˥
phắt	făt˦˥
phẳng	făŋ˧˩˨
phặng	făŋ˨ˀ˩ʔ
phẹc	fɛk˨ˀ˩
phẹt	fɛt˨ˀ˩
phế	fe˨˦
phếch	fek˦˥
phết	fet˦˥
phề	fe˧˨
phềnh	feŋ˧˨
phều	fɛu˧˨
phễn	fen˧ˀ˥
phễu	fɛu˧ˀ˥
phệ	fe˨ˀ˩ʔ
phệnh	feŋ˨ˀ˩ʔ
phệt	fet˨ˀ˩
phệu	fɛu˨ˀ˩ʔ
phỉ	fi˧˩˨
phỉnh	fiŋ˧˩˨
phị	fi˨ˀ˩ʔ
phịa	fiə˨ˀ˩ʔ
phịch	fik˨ˀ˩
phịt	fit˨ˀ˩
phịu	fiw˨ˀ˩ʔ
phọc	fɔk͡p˨ˀ˩
phọng	fɔŋ͡m˨ˀ˩ʔ
phọp	fɔp˨ˀ˩
phọt	fɔt˨ˀ˩
phỏng	fɔŋ͡m˧˩˨
phố	fo˨˦
phốc	fok͡p˦˥
phối	foj˨˦
phốp	fop˦˥
phốt	fot˦˥
phồ	fo˧˨
phồm	fom˧˨
phồn	fon˧˨
phồng	foŋ͡m˧˨
phổ	fo˧˩˨
phổi	foj˧˩˨
phổng	foŋ͡m˧˩˨
phỗng	foŋ͡m˧ˀ˥
phộng	foŋ͡m˨ˀ˩ʔ
phớ	fɤ˨˦
phới	fɤj˨˦
phớn	fɤn˨˦
phớt	fɤt˦˥
phờ	fɤ˧˨
phời	fɤj˧˨
phở	fɤ˧˩˨
phởn	fɤn˧˩˨
phỡn	fɤn˧ˀ˥
phụ	fu˨ˀ˩ʔ
phục	fuk͡p˨ˀ˩
phụng	fuŋ͡m˨ˀ˩ʔ
phụp	fup˨ˀ˩
phụt	fut˨ˀ˩
phủ	fu˧˩˨
phủi	fuj˧˩˨
phủng	fuŋ͡m˧˩˨
phứa	fɯə˨˦
phức	fɯk˦˥
phứt	fɯt˦˥
phừn	fɯn˧˨
phừng	fɯŋ˧˨
phựa	fɯə˨ˀ˩ʔ
phực	fɯk˨ˀ˩
phựt	fɯt˨ˀ˩
pi	pi˧˧
pin	pin˧˧
ping	piŋ˧˧
pinh	piŋ˧˧
piêu	piəw˧˧
po	pɔ˧˧
poa	pwa˧˧
pom	pɔm˧˧
pong	pɔŋ͡m˧˧
pop	pɔp˧˧
poọng	pɔɔŋ͡m˨ˀ˩ʔ
pu	pu˧˧
pua	puə˧˧
pui	puj˧˧
pun	pun˧˧
puy	pwi˧˧
puốc	puək˦˥
puộc	puək˨ˀ˩
pà	pa˧˨
pài	paj˧˨
pàng	paŋ˧˨
pác	pak˦˥
pán	pan˨˦
páp	pap˦˥
pát	pat˦˥
pâu	pɤ̆w˧˧
péc	pɛk˦˥
péo	peo˨˦
pét	pɛt˦˥
pê	pe˧˧
píc	pik˦˥
pích	pik˦˥
píp	pip˦˥
pít	pit˦˥
pô	po˧˧
pông	poŋ͡m˧˧
pôông	poŋ͡m˧˧
păng	păŋ˧˧
pơ	pɤ˧˧
pơng	pɤŋ˧˧
pươi	pɯəj˧˧
pạ	pa˨ˀ˩ʔ
pả	pa˧˩˨
pấc	pɤ̆k˦˥
pắc	păk˦˥
pằn	păn˧˨
pẹc	pɛk˨ˀ˩
pẻ	pɛ˧˩˨
pếch	pek˦˥
pết	pet˦˥
pốt	pot˦˥
pờ	pɤ˧˨
pụa	puə˨ˀ˩ʔ
qua	kwa˧˧
quai	kwaj˧˧
quan	kwan˧˧
quang	kwaŋ˧˧
quanh	kwɛŋ˧˧
quao	kwaw˧˧
quau	kwăw˧˧
quay	kwăj˧˧
que	kwɛ˧˧
quen	kwɛn˧˧
queng	kwɛŋ˧˧
queo	kweo˧˧
qui	kwi˧˧
quoàng	kwaŋ˧˨
quoạng	kwaŋ˨ˀ˩ʔ
quoắt	kwăt˦˥
quuyết	kwiət˦˥
quy	kwi˧˧
quyên	kwiɛn˧˧
quyến	kwiɛn˨˦
quyết	kwiɛt˦˥
quyền	kwiɛn˧˨
quyển	kwiɛn˧˩˨
quyện	kwiɛn˨ˀ˩ʔ
quyệt	kwiɛt˨ˀ˩
quà	kwa˧˨
quài	kwaj˧˨
quàn	kwan˧˨
quàng	kwaŋ˧˨
quành	kwɛŋ˧˨
quào	kwaw˧˨
quàu	kwăw˧˨
quày	kwăj˧˨
quá	kwa˨˦
quác	kwak˦˥
quách	kwɛk˦˥
quái	kwaj˨˦
quán	kwan˨˦
quáng	kwaŋ˨˦
quánh	kwɛŋ˨˦
quáo	kwaw˨˦
quát	kwat˦˥
quáu	kwăw˨˦
quáy	kwăj˨˦
quân	kwɤ̆n˧˧
quây	kwɤ̆j˧˧
quãng	kwaŋ˧ˀ˥
què	kwɛ˧˨
quèn	kwɛn˧˨
quèo	kweo˧˨
qué	kwɛ˨˦
quéc	kwɛk˦˥
quén	kwɛn˨˦
quéo	kweo˨˦
quét	kwɛt˦˥
quê	kwe˧˧
quên	kwen˧˧
quì	kwi˧˨
quình	kwiŋ˧˨
quí	kwi˨˦
quích	kwik˦˥
quít	kwit˦˥
quý	kwi˨˦
quých	kwik˦˥
quýnh	kwiŋ˨˦
quýt	kwit˦˥
quăm	kwăm˧˧
quăn	kwăn˧˧
quăng	kwăŋ˧˧
quĩ	kwi˧ˀ˥
quơ	kwɤ˧˧
quạ	kwa˨ˀ˩ʔ
quạc	kwak˨ˀ˩
quạch	kwɛk˨ˀ˩
quại	kwaj˨ˀ˩ʔ
quạng	kwaŋ˨ˀ˩ʔ
quạnh	kwɛŋ˨ˀ˩ʔ
quạo	kwaw˨ˀ˩ʔ
quạt	kwat˨ˀ˩
quạu	kwăw˨ˀ˩ʔ
quạy	kwăj˨ˀ˩ʔ
quả	kwa˧˩˨
quải	kwaj˧˩˨
quản	kwan˧˩˨
quảng	kwaŋ˧˩˨
quảy	kwăj˧˩˨
quấc	kwɤ̆k˦˥
quấn	kwɤ̆n˨˦
quất	kwɤ̆t˦˥
quấy	kwɤ̆j˨˦
quần	kwɤ̆n˧˨
quầng	kwɤ̆ŋ˧˨
quầy	kwɤ̆j˧˨
quẩn	kwɤ̆n˧˩˨
quẩng	kwɤ̆ŋ˧˩˨
quẩy	kwɤ̆j˧˩˨
quẫn	kwɤ̆n˧ˀ˥
quẫy	kwɤ̆j˧ˀ˥
quận	kwɤ̆n˨ˀ˩ʔ
quật	kwɤ̆t˨ˀ˩
quậy	kwɤ̆j˨ˀ˩ʔ
quắc	kwăk˦˥
quắm	kwăm˨˦
quắn	kwăn˨˦
quắp	kwăp˦˥
quắt	kwăt˦˥
quằm	kwăm˧˨
quằn	kwăn˧˨
quẳm	kwăm˧˩˨
quẳng	kwăŋ˧˩˨
quặc	kwăk˨ˀ˩
quặm	kwăm˨ˀ˩ʔ
quặn	kwăn˨ˀ˩ʔ
quặng	kwăŋ˨ˀ˩ʔ
quặp	kwăp˨ˀ˩
quặt	kwăt˨ˀ˩
quẹn	kwɛn˨ˀ˩ʔ
quẹo	kweo˨ˀ˩ʔ
quẹt	kwɛt˨ˀ˩
quẻ	kwɛ˧˩˨
quẽ	kwɛ˧ˀ˥
quế	kwe˨˦
quếch	kwek˦˥
quến	kwen˨˦
quếnh	kweŋ˨˦
quết	kwet˦˥
quếu	kwɛu˨˦
quề	kwe˧˨
quềnh	kweŋ˧˨
quều	kwɛu˧˨
quệ	kwe˨ˀ˩ʔ
quệch	kwek˨ˀ˩
quện	kwen˨ˀ˩ʔ
quệnh	kweŋ˨ˀ˩ʔ
quệt	kwet˨ˀ˩
quỉ	kwi˧˩˨
quị	kwi˨ˀ˩ʔ
quịt	kwit˨ˀ˩
quọ	kwɔ˨ˀ˩ʔ
quốc	kwok͡p˦˥
quớ	kwɤ˨˦
quới	kwɤj˨˦
quờ	kwɤ˧˨
quờn	kwɤn˧˨
quở	kwɤ˧˩˨
quỳ	kwi˧˨
quỳnh	kwiŋ˧˨
quỵ	kwi˨ˀ˩ʔ
quỵp	kwip˨ˀ˩
quỵt	kwit˨ˀ˩
quỷ	kwi˧˩˨
quỷnh	kwiŋ˧˩˨
quỹ	kwi˧ˀ˥
qùy	kwi˧˨
qúy	kwi˨˦
qũy	kwi˧ˀ˥
qụy	kwi˨ˀ˩ʔ
ra	ra˧˧
rai	raj˧˧
ram	ram˧˧
ran	ran˧˧
rang	raŋ˧˧
ranh	rɛŋ˧˧
rao	raw˧˧
rat	rat˧˧
rau	răw˧˧
ray	răj˧˧
re	rɛ˧˧
rem	rɛm˧˧
ren	rɛn˧˧
reng	rɛŋ˧˧
reo	reo˧˧
ri	ri˧˧
ria	riə˧˧
rim	rim˧˧
rin	rin˧˧
ring	riŋ˧˧
rinh	riŋ˧˧
rit	rit˧˧
riu	riw˧˧
rià	riə˧˨
riên	riən˧˧
riêng	riəŋ˧˧
riêu	riəw˧˧
riết	riət˦˥
riếu	riəw˨˦
riềm	riəm˧˨
riềng	riəŋ˧˨
riễu	riəw˧ˀ˥
riệt	riət˨ˀ˩
ro	rɔ˧˧
roa	rwa˧˧
roi	rɔj˧˧
rom	rɔm˧˧
ron	rɔn˧˧
rong	rɔŋ͡m˧˧
roàng	rwaŋ˧˨
roòng	rɔɔŋ͡m˧˨
roạt	rwat˨ˀ˩
ru	ru˧˧
rua	ruə˧˧
rui	ruj˧˧
rum	rum˧˧
run	run˧˧
rung	ruŋ͡m˧˧
ruy	rwi˧˧
ruê	rwe˧˧
ruôn	ruən˧˧
ruýp	rwip˦˥
ruốc	ruək˦˥
ruối	ruəj˨˦
ruốt	ruət˦˥
ruồi	ruəj˧˨
ruồng	ruəŋ˧˨
ruổi	ruəj˧˩˨
ruỗng	ruəŋ˧ˀ˥
ruộm	ruəm˨ˀ˩ʔ
ruộng	ruəŋ˨ˀ˩ʔ
ruột	ruət˨ˀ˩
rà	ra˧˨
rài	raj˧˨
ràn	ran˧˨
ràng	raŋ˧˨
rành	rɛŋ˧˨
rào	raw˧˨
rày	răj˧˨
rá	ra˨˦
rác	rak˦˥
rách	rɛk˦˥
rái	raj˨˦
rám	ram˨˦
rán	ran˨˦
ráng	raŋ˨˦
ráo	raw˨˦
ráp	rap˦˥
rát	rat˦˥
ráu	răw˨˦
ráy	răj˨˦
râm	rɤ̆m˧˧
rân	rɤ̆n˧˧
râu	rɤ̆w˧˧
rây	rɤ̆j˧˧
rã	ra˧ˀ˥
rãi	raj˧ˀ˥
rãnh	rɛŋ˧ˀ˥
rão	raw˧ˀ˥
rãy	răj˧ˀ˥
rè	rɛ˧˨
rèm	rɛm˧˨
rèn	rɛn˧˨
rèo	reo˧˨
ré	rɛ˨˦
rén	rɛn˨˦
réo	reo˨˦
rét	rɛt˦˥
rê	re˧˧
rêm	rem˧˧
rên	ren˧˧
rêu	rɛu˧˧
rì	ri˧˨
rìa	riə˧˨
rình	riŋ˧˨
rìu	riw˧˨
rí	ri˨˦
rích	rik˦˥
rím	rim˨˦
ríp	rip˦˥
rít	rit˦˥
ríu	riw˨˦
rò	rɔ˧˨
ròi	rɔj˧˨
ròm	rɔm˧˨
ròn	rɔn˧˨
ròng	rɔŋ͡m˧˨
ró	rɔ˨˦
róc	rɔk͡p˦˥
rói	rɔj˨˦
róm	rɔm˨˦
rón	rɔn˨˦
róng	rɔŋ͡m˨˦
rót	rɔt˦˥
rô	ro˧˧
rôm	rom˧˧
rôn	ron˧˧
rông	roŋ͡m˧˧
rõ	rɔ˧ˀ˥
rõi	rɔj˧ˀ˥
rù	ru˧˨
rùa	ruə˧˨
rùm	rum˧˨
rùn	run˧˨
rùng	ruŋ͡m˧˨
rú	ru˨˦
rúc	ruk͡p˦˥
rúi	ruj˨˦
rúm	rum˨˦
rún	run˨˦
rúng	ruŋ͡m˨˦
rúp	rup˦˥
rút	rut˦˥
răm	răm˧˧
răn	răn˧˧
răng	răŋ˧˧
rĩ	ri˧ˀ˥
rĩn	rin˧ˀ˥
rũ	ru˧ˀ˥
rũa	ruə˧ˀ˥
rơ	rɤ˧˧
rơi	rɤj˧˧
rơm	rɤm˧˧
rơn	rɤn˧˧
rư	rɯ˧˧
rưa	rɯə˧˧
rưng	rɯŋ˧˧
rươi	rɯəj˧˧
rươm	rɯəm˧˧
rương	rɯəŋ˧˧
rước	rɯək˦˥
rưới	rɯəj˨˦
rướm	rɯəm˨˦
rướn	rɯən˨˦
rười	rɯəj˧˨
rườm	rɯəm˧˨
rườn	rɯən˧˨
rường	rɯəŋ˧˨
rưởi	rɯəj˧˩˨
rưỡi	rɯəj˧ˀ˥
rượi	rɯəj˨ˀ˩ʔ
rượn	rɯən˨ˀ˩ʔ
rượng	rɯəŋ˨ˀ˩ʔ
rượt	rɯət˨ˀ˩
rượu	rɯəw˨ˀ˩ʔ
rạ	ra˨ˀ˩ʔ
rạc	rak˨ˀ˩
rạch	rɛk˨ˀ˩
rạm	ram˨ˀ˩ʔ
rạn	ran˨ˀ˩ʔ
rạng	raŋ˨ˀ˩ʔ
rạo	raw˨ˀ˩ʔ
rạp	rap˨ˀ˩
rạt	rat˨ˀ˩
rạy	răj˨ˀ˩ʔ
rả	ra˧˩˨
rải	raj˧˩˨
rảng	raŋ˧˩˨
rảnh	rɛŋ˧˩˨
rảo	raw˧˩˨
rảu	răw˧˩˨
rảy	răj˧˩˨
rấm	rɤ̆m˨˦
rấn	rɤ̆n˨˦
rấp	rɤ̆p˦˥
rất	rɤ̆t˦˥
rầm	rɤ̆m˧˨
rần	rɤ̆n˧˨
rầu	rɤ̆w˧˨
rầy	rɤ̆j˧˨
rẩm	rɤ̆m˧˩˨
rẩy	rɤ̆j˧˩˨
rẫm	rɤ̆m˧ˀ˥
rẫy	rɤ̆j˧ˀ˥
rậm	rɤ̆m˨ˀ˩ʔ
rận	rɤ̆n˨ˀ˩ʔ
rập	rɤ̆p˨ˀ˩
rật	rɤ̆t˨ˀ˩
rậu	rɤ̆w˨ˀ˩ʔ
rắc	răk˦˥
rắm	răm˨˦
rắn	răn˨˦
rắp	răp˦˥
rắt	răt˦˥
rằm	răm˧˨
rằn	răn˧˨
rằng	răŋ˧˨
rặc	răk˨ˀ˩
rặm	răm˨ˀ˩ʔ
rặn	răn˨ˀ˩ʔ
rặng	răŋ˨ˀ˩ʔ
rặt	răt˨ˀ˩
rẹo	reo˨ˀ˩ʔ
rẹt	rɛt˨ˀ˩
rẻ	rɛ˧˩˨
rẻng	rɛŋ˧˩˨
rẻo	reo˧˩˨
rẽ	rɛ˧ˀ˥
rế	re˨˦
rếch	rek˦˥
rến	ren˨˦
rếp	rep˦˥
rết	ret˦˥
rề	re˧˨
rền	ren˧˨
rềnh	reŋ˧˨
rều	rɛu˧˨
rể	re˧˩˨
rểnh	reŋ˧˩˨
rễ	re˧ˀ˥
rệ	re˨ˀ˩ʔ
rệch	rek˨ˀ˩
rện	ren˨ˀ˩ʔ
rệp	rep˨ˀ˩
rệt	ret˨ˀ˩
rệu	rɛu˨ˀ˩ʔ
rỉ	ri˧˩˨
rỉa	riə˧˩˨
rỉn	rin˧˩˨
rỉnh	riŋ˧˩˨
rị	ri˨ˀ˩ʔ
rịa	riə˨ˀ˩ʔ
rịch	rik˨ˀ˩
rịn	rin˨ˀ˩ʔ
rịp	rip˨ˀ˩
rịt	rit˨ˀ˩
rọ	rɔ˨ˀ˩ʔ
rọc	rɔk͡p˨ˀ˩
rọi	rɔj˨ˀ˩ʔ
rọm	rɔm˨ˀ˩ʔ
rọn	rɔn˨ˀ˩ʔ
rọt	rɔt˨ˀ˩
rỏ	rɔ˧˩˨
rỏi	rɔj˧˩˨
rỏm	rɔm˧˩˨
rỏn	rɔn˧˩˨
rỏng	rɔŋ͡m˧˩˨
rốc	rok͡p˦˥
rối	roj˨˦
rốn	ron˨˦
rống	roŋ͡m˨˦
rốp	rop˦˥
rốt	rot˦˥
rồ	ro˧˨
rồi	roj˧˨
rồm	rom˧˨
rồn	ron˧˨
rồng	roŋ͡m˧˨
rổ	ro˧˩˨
rổi	roj˧˩˨
rổn	ron˧˩˨
rổng	roŋ͡m˧˩˨
rỗ	ro˧ˀ˥
rỗi	roj˧ˀ˥
rỗng	roŋ͡m˧ˀ˥
rộ	ro˨ˀ˩ʔ
rộc	rok͡p˨ˀ˩
rộm	rom˨ˀ˩ʔ
rộn	ron˨ˀ˩ʔ
rộng	roŋ͡m˨ˀ˩ʔ
rộp	rop˨ˀ˩
rột	rot˨ˀ˩
rớ	rɤ˨˦
rớm	rɤm˨˦
rớp	rɤp˦˥
rớt	rɤt˦˥
rờ	rɤ˧˨
rời	rɤj˧˨
rờm	rɤm˧˨
rờn	rɤn˧˨
rở	rɤ˧˩˨
rởm	rɤm˧˩˨
rởn	rɤn˧˩˨
rỡ	rɤ˧ˀ˥
rỡn	rɤn˧ˀ˥
rợ	rɤ˨ˀ˩ʔ
rợi	rɤj˨ˀ˩ʔ
rợm	rɤm˨ˀ˩ʔ
rợn	rɤn˨ˀ˩ʔ
rợp	rɤp˨ˀ˩
rợt	rɤt˨ˀ˩
rụ	ru˨ˀ˩ʔ
rụa	ruə˨ˀ˩ʔ
rục	ruk͡p˨ˀ˩
rụi	ruj˨ˀ˩ʔ
rụm	rum˨ˀ˩ʔ
rụng	ruŋ͡m˨ˀ˩ʔ
rụp	rup˨ˀ˩
rụt	rut˨ˀ˩
rủ	ru˧˩˨
rủa	ruə˧˩˨
rủi	ruj˧˩˨
rủn	run˧˩˨
rủng	ruŋ͡m˧˩˨
rứa	rɯə˨˦
rức	rɯk˦˥
rứt	rɯt˦˥
rừ	rɯ˧˨
rừng	rɯŋ˧˨
rửa	rɯə˧˩˨
rửng	rɯŋ˧˩˨
rữa	rɯə˧ˀ˥
rựa	rɯə˨ˀ˩ʔ
rực	rɯk˨ˀ˩
rựng	rɯŋ˨ˀ˩ʔ
rỵn	rin˨ˀ˩ʔ
sa	sa˧˧
sai	saj˧˧
sam	sam˧˧
san	san˧˧
sang	saŋ˧˧
sanh	sɛŋ˧˧
sao	saw˧˧
sau	săw˧˧
say	săj˧˧
se	sɛ˧˧
sen	sɛn˧˧
seo	seo˧˧
si	si˧˧
sia	siə˧˧
sic	sik˧˧
sim	sim˧˧
sin	sin˧˧
sinh	siŋ˧˧
siu	siw˧˧
siêng	siəŋ˧˧
siêu	siəw˧˧
siếc	siək˦˥
siết	siət˦˥
siểm	siəm˧˩˨
siểng	siəŋ˧˩˨
siễn	siən˧ˀ˥
so	sɔ˧˧
soa	swa˧˧
soi	sɔj˧˧
som	sɔm˧˧
son	sɔn˧˧
song	sɔŋ͡m˧˧
soong	sɔɔŋ͡m˧˧
soà	swa˧˨
soài	swaj˧˨
soàm	swam˧˨
soàn	swan˧˨
soái	swaj˨˦
soán	swan˨˦
soát	swat˦˥
soóc	sɔɔk͡p˦˥
soạn	swan˨ˀ˩ʔ
soạng	swaŋ˨ˀ˩ʔ
soạp	swap˨ˀ˩
soạt	swat˨ˀ˩
soải	swaj˧˩˨
soảng	swaŋ˧˩˨
soẹt	swet˨ˀ˩
su	su˧˧
sua	suə˧˧
sui	suj˧˧
sum	sum˧˧
sun	sun˧˧
sung	suŋ͡m˧˧
suy	swi˧˧
suyển	swiən˧˩˨
suyễn	swiən˧ˀ˥
suê	swe˧˧
suôn	suən˧˧
suông	suəŋ˧˧
suý	swi˨˦
suýt	swit˦˥
suất	swɤ̆t˦˥
suối	suəj˨˦
suốt	suət˦˥
suồng	suəŋ˧˨
suỵt	swit˨ˀ˩
sà	sa˧˨
sài	saj˧˨
sàm	sam˧˨
sàn	san˧˨
sàng	saŋ˧˨
sành	sɛŋ˧˨
sào	saw˧˨
sá	sa˨˦
sác	sak˦˥
sách	sɛk˦˥
sái	saj˨˦
sám	sam˨˦
sán	san˨˦
sáng	saŋ˨˦
sánh	sɛŋ˨˦
sáo	saw˨˦
sáp	sap˦˥
sát	sat˦˥
sáu	săw˨˦
sâm	sɤ̆m˧˧
sân	sɤ̆n˧˧
sâng	sɤ̆ŋ˧˧
sâu	sɤ̆w˧˧
sây	sɤ̆j˧˧
sã	sa˧ˀ˥
sãi	saj˧ˀ˥
sè	sɛ˧˨
sèo	seo˧˨
séc	sɛk˦˥
sém	sɛm˨˦
séo	seo˨˦
sét	sɛt˦˥
sê	se˧˧
sên	sen˧˧
sênh	seŋ˧˧
sêu	sɛu˧˧
sì	si˧˨
sìn	sin˧˨
sình	siŋ˧˨
síc	sik˦˥
sích	sik˦˥
sín	sin˨˦
sính	siŋ˨˦
sít	sit˦˥
sò	sɔ˧˨
sòa	swa˧˨
sòi	sɔj˧˨
sòm	sɔm˧˨
sòn	sɔn˧˨
sòng	sɔŋ͡m˧˨
sóc	sɔk͡p˦˥
sói	sɔj˨˦
sóm	sɔm˨˦
són	sɔn˨˦
sóng	sɔŋ͡m˨˦
sóoc	sɔɔk͡p˦˥
sóp	sɔp˦˥
sót	sɔt˦˥
sô	so˧˧
sôi	soj˧˧
sông	soŋ͡m˧˧
sõi	sɔj˧ˀ˥
sõng	sɔŋ͡m˧ˀ˥
sù	su˧˨
sùi	suj˧˨
sùm	sum˧˨
sùng	suŋ͡m˧˨
sú	su˨˦
súc	suk͡p˦˥
sún	sun˨˦
súng	suŋ͡m˨˦
súp	sup˦˥
sút	sut˦˥
súy	swi˨˦
săm	săm˧˧
săn	săn˧˧
săng	săŋ˧˧
sĩ	si˧ˀ˥
sũng	suŋ͡m˧ˀ˥
sơ	sɤ˧˧
sơm	sɤm˧˧
sơn	sɤn˧˧
sư	sɯ˧˧
sưa	sɯə˧˧
sưng	sɯŋ˧˧
sưu	sɯw˧˧
sươi	sɯəj˧˧
sương	sɯəŋ˧˧
sướng	sɯəŋ˨˦
sướt	sɯət˦˥
sườn	sɯən˧˨
sường	sɯəŋ˧˨
sưởi	sɯəj˧˩˨
sượng	sɯəŋ˨ˀ˩ʔ
sượt	sɯət˨ˀ˩
sạ	sa˨ˀ˩ʔ
sạc	sak˨ˀ˩
sạch	sɛk˨ˀ˩
sại	saj˨ˀ˩ʔ
sạm	sam˨ˀ˩ʔ
sạn	san˨ˀ˩ʔ
sạo	saw˨ˀ˩ʔ
sạp	sap˨ˀ˩
sạt	sat˨ˀ˩
sả	sa˧˩˨
sải	saj˧˩˨
sản	san˧˩˨
sảng	saŋ˧˩˨
sảnh	sɛŋ˧˩˨
sảo	saw˧˩˨
sảy	săj˧˩˨
sấm	sɤ̆m˨˦
sấn	sɤ̆n˨˦
sấp	sɤ̆p˦˥
sất	sɤ̆t˦˥
sấu	sɤ̆w˨˦
sấy	sɤ̆j˨˦
sầm	sɤ̆m˧˨
sần	sɤ̆n˧˨
sầu	sɤ̆w˧˨
sầy	sɤ̆j˧˨
sẩm	sɤ̆m˧˩˨
sẩn	sɤ̆n˧˩˨
sẩy	sɤ̆j˧˩˨
sẫm	sɤ̆m˧ˀ˥
sậm	sɤ̆m˨ˀ˩ʔ
sập	sɤ̆p˨ˀ˩
sật	sɤ̆t˨ˀ˩
sậu	sɤ̆w˨ˀ˩ʔ
sậy	sɤ̆j˨ˀ˩ʔ
sắc	săk˦˥
sắm	săm˨˦
sắn	săn˨˦
sắng	săŋ˨˦
sắp	săp˦˥
sắt	săt˦˥
sằng	săŋ˧˨
sẵn	săn˧ˀ˥
sẵp	săp˧ˀ˥
sặc	săk˨ˀ˩
sặm	săm˨ˀ˩ʔ
sặt	săt˨ˀ˩
sẹ	sɛ˨ˀ˩ʔ
sẹm	sɛm˨ˀ˩ʔ
sẹo	seo˨ˀ˩ʔ
sẹp	sɛp˨ˀ˩
sẹt	sɛt˨ˀ˩
sẻ	sɛ˧˩˨
sẻn	sɛn˧˩˨
sẽ	sɛ˧ˀ˥
sến	sen˨˦
sếp	sep˦˥
sếu	sɛu˨˦
sề	se˧˨
sền	sen˧˨
sềnh	seŋ˧˨
sều	sɛu˧˨
sể	se˧˩˨
sểnh	seŋ˧˩˨
sễ	se˧ˀ˥
sệ	se˨ˀ˩ʔ
sệch	sek˨ˀ˩
sệp	sep˨ˀ˩
sệt	set˨ˀ˩
sỉ	si˧˩˨
sỉa	siə˧˩˨
sỉnh	siŋ˧˩˨
sị	si˨ˀ˩ʔ
sịa	siə˨ˀ˩ʔ
sịch	sik˨ˀ˩
sịt	sit˨ˀ˩
sọ	sɔ˨ˀ˩ʔ
sọc	sɔk͡p˨ˀ˩
sọm	sɔm˨ˀ˩ʔ
sọt	sɔt˨ˀ˩
sỏ	sɔ˧˩˨
sỏi	sɔj˧˩˨
số	so˨˦
sốc	sok͡p˦˥
sống	soŋ͡m˨˦
sốp	sop˦˥
sốt	sot˦˥
sồ	so˧˨
sồi	soj˧˨
sồn	son˧˨
sồng	soŋ͡m˧˨
sổ	so˧˩˨
sổi	soj˧˩˨
sổng	soŋ͡m˧˩˨
sỗ	so˧ˀ˥
sộ	so˨ˀ˩ʔ
sộc	sok͡p˨ˀ˩
sộp	sop˨ˀ˩
sột	sot˨ˀ˩
sớ	sɤ˨˦
sới	sɤj˨˦
sớm	sɤm˨˦
sớn	sɤn˨˦
sớt	sɤt˦˥
sờ	sɤ˧˨
sờm	sɤm˧˨
sờn	sɤn˧˨
sở	sɤ˧˩˨
sởi	sɤj˧˩˨
sởn	sɤn˧˩˨
sỡ	sɤ˧ˀ˥
sợ	sɤ˨ˀ˩ʔ
sợi	sɤj˨ˀ˩ʔ
sụ	su˨ˀ˩ʔ
sụa	suə˨ˀ˩ʔ
sục	suk͡p˨ˀ˩
sụm	sum˨ˀ˩ʔ
sụn	sun˨ˀ˩ʔ
sụp	sup˨ˀ˩
sụt	sut˨ˀ˩
sủ	su˧˩˨
sủa	suə˧˩˨
sủi	suj˧˩˨
sủng	suŋ͡m˧˩˨
sứ	sɯ˨˦
sứa	sɯə˨˦
sức	sɯk˦˥
sứt	sɯt˦˥
sừn	sɯn˧˨
sừng	sɯŋ˧˨
sử	sɯ˧˩˨
sửa	sɯə˧˩˨
sửng	sɯŋ˧˩˨
sửu	sɯw˧˩˨
sữa	sɯə˧ˀ˥
sững	sɯŋ˧ˀ˥
sự	sɯ˨ˀ˩ʔ
sực	sɯk˨ˀ˩
sựng	sɯŋ˨ˀ˩ʔ
sựt	sɯt˨ˀ˩
sỹ	si˧ˀ˥
ta	ta˧˧
tai	taj˧˧
tam	tam˧˧
tan	tan˧˧
tang	taŋ˧˧
tanh	tɛŋ˧˧
tao	taw˧˧
tau	tăw˧˧
tay	tăj˧˧
te	tɛ˧˧
tem	tɛm˧˧
ten	tɛn˧˧
teng	tɛŋ˧˧
teo	teo˧˧
tha	tʰa˧˧
thai	tʰaj˧˧
tham	tʰam˧˧
than	tʰan˧˧
thang	tʰaŋ˧˧
thanh	tʰɛŋ˧˧
thao	tʰaw˧˧
thau	tʰăw˧˧
thay	tʰăj˧˧
the	tʰɛ˧˧
then	tʰɛn˧˧
theo	tʰeo˧˧
thi	tʰi˧˧
thia	tʰiə˧˧
thin	tʰin˧˧
thinh	tʰiŋ˧˧
thiu	tʰiw˧˧
thiêm	tʰiəm˧˧
thiên	tʰiən˧˧
thiêng	tʰiəŋ˧˧
thiêu	tʰiəw˧˧
thiếc	tʰiək˦˥
thiến	tʰiən˨˦
thiếp	tʰiəp˦˥
thiết	tʰiət˦˥
thiếu	tʰiəw˨˦
thiềm	tʰiəm˧˨
thiền	tʰiən˧˨
thiềng	tʰiəŋ˧˨
thiều	tʰiəw˧˨
thiểm	tʰiəm˧˩˨
thiển	tʰiən˧˩˨
thiểu	tʰiəw˧˩˨
thiện	tʰiən˨ˀ˩ʔ
thiệp	tʰiəp˨ˀ˩
thiệt	tʰiət˨ˀ˩
thiệu	tʰiəw˨ˀ˩ʔ
tho	tʰɔ˧˧
thoa	tʰwa˧˧
thoai	tʰwaj˧˧
thoang	tʰwaŋ˧˧
thoi	tʰɔj˧˧
thom	tʰɔm˧˧
thon	tʰɔn˧˧
thong	tʰɔŋ͡m˧˧
thoà	tʰwa˧˨
thoàn	tʰwan˧˨
thoá	tʰwa˨˦
thoái	tʰwaj˨˦
thoán	tʰwan˨˦
thoáng	tʰwaŋ˨˦
thoát	tʰwat˦˥
thoã	tʰwa˧ˀ˥
thoòng	tʰɔɔŋ͡m˧˨
thoăn	tʰwăn˧˧
thoại	tʰwaj˨ˀ˩ʔ
thoạt	tʰwat˨ˀ˩
thoả	tʰwa˧˩˨
thoải	tʰwaj˧˩˨
thoảng	tʰwaŋ˧˩˨
thoắng	tʰwăŋ˨˦
thoắt	tʰwăt˦˥
thu	tʰu˧˧
thua	tʰuə˧˧
thui	tʰuj˧˧
thum	tʰum˧˧
thun	tʰun˧˧
thung	tʰuŋ͡m˧˧
thuyên	tʰwiən˧˧
thuyết	tʰwiət˦˥
thuyền	tʰwiən˧˨
thuê	tʰwe˧˧
thuôn	tʰuən˧˧
thuông	tʰuəŋ˧˧
thuý	tʰwi˨˦
thuơng	tʰuəŋ˧˧
thuấn	tʰwɤ̆n˨˦
thuần	tʰwɤ̆n˧˨
thuẫn	tʰwɤ̆n˧ˀ˥
thuận	tʰwɤ̆n˨ˀ˩ʔ
thuật	tʰwɤ̆t˨ˀ˩
thuế	tʰwe˨˦
thuể	tʰwe˧˩˨
thuốc	tʰuək˦˥
thuốn	tʰuən˨˦
thuồi	tʰuəj˧˨
thuồn	tʰuən˧˨
thuồng	tʰuəŋ˧˨
thuổc	tʰuək˧˩˨
thuổng	tʰuəŋ˧˩˨
thuỗn	tʰuən˧ˀ˥
thuộc	tʰuək˨ˀ˩
thuội	tʰuəj˨ˀ˩ʔ
thuộm	tʰuəm˨ˀ˩ʔ
thuột	tʰuət˨ˀ˩
thuở	tʰuə˧˩˨
thuỳ	tʰwi˧˨
thuỵ	tʰwi˨ˀ˩ʔ
thuỷ	tʰwi˧˩˨
thà	tʰa˧˨
thài	tʰaj˧˨
thàm	tʰam˧˨
thàng	tʰaŋ˧˨
thành	tʰɛŋ˧˨
thào	tʰaw˧˨
thày	tʰăj˧˨
thá	tʰa˨˦
thác	tʰak˦˥
thách	tʰɛk˦˥
thái	tʰaj˨˦
thám	tʰam˨˦
thán	tʰan˨˦
tháng	tʰaŋ˨˦
thánh	tʰɛŋ˨˦
tháo	tʰaw˨˦
tháp	tʰap˦˥
thát	tʰat˦˥
tháu	tʰăw˨˦
tháy	tʰăj˨˦
thâm	tʰɤ̆m˧˧
thân	tʰɤ̆n˧˧
thâu	tʰɤ̆w˧˧
thây	tʰɤ̆j˧˧
thãi	tʰaj˧ˀ˥
thè	tʰɛ˧˨
thèm	tʰɛm˧˨
thèn	tʰɛn˧˨
thèo	tʰeo˧˨
thé	tʰɛ˨˦
thép	tʰɛp˦˥
thét	tʰɛt˦˥
thê	tʰe˧˧
thêm	tʰem˧˧
thênh	tʰeŋ˧˧
thêu	tʰɛu˧˧
thì	tʰi˧˨
thìa	tʰiə˧˨
thìn	tʰin˧˨
thình	tʰiŋ˧˨
thìu	tʰiw˧˨
thí	tʰi˨˦
thía	tʰiə˨˦
thích	tʰik˦˥
thím	tʰim˨˦
thín	tʰin˨˦
thính	tʰiŋ˨˦
thíp	tʰip˦˥
thít	tʰit˦˥
thò	tʰɔ˧˨
thòa	tʰwa˧˨
thòi	tʰɔj˧˨
thòm	tʰɔm˧˨
thòng	tʰɔŋ͡m˧˨
thó	tʰɔ˨˦
thóa	tʰwa˨˦
thóc	tʰɔk͡p˦˥
thói	tʰɔj˨˦
thóm	tʰɔm˨˦
thóp	tʰɔp˦˥
thót	tʰɔt˦˥
thô	tʰo˧˧
thôi	tʰoj˧˧
thôn	tʰon˧˧
thông	tʰoŋ͡m˧˧
thõa	tʰwa˧ˀ˥
thõm	tʰɔm˧ˀ˥
thõng	tʰɔŋ͡m˧ˀ˥
thù	tʰu˧˨
thùa	tʰuə˧˨
thùi	tʰuj˧˨
thùm	tʰum˧˨
thùn	tʰun˧˨
thùng	tʰuŋ͡m˧˨
thùy	tʰwi˧˨
thú	tʰu˨˦
thúc	tʰuk͡p˦˥
thúi	tʰuj˨˦
thúng	tʰuŋ͡m˨˦
thút	tʰut˦˥
thúy	tʰwi˨˦
thăm	tʰăm˧˧
thăn	tʰăn˧˧
thăng	tʰăŋ˧˧
thĩ	tʰi˧ˀ˥
thũng	tʰuŋ͡m˧ˀ˥
thơ	tʰɤ˧˧
thơi	tʰɤj˧˧
thơm	tʰɤm˧˧
thơn	tʰɤn˧˧
thư	tʰɯ˧˧
thưa	tʰɯə˧˧
thưng	tʰɯŋ˧˧
thương	tʰɯəŋ˧˧
thước	tʰɯək˦˥
thướng	tʰɯəŋ˨˦
thướt	tʰɯət˦˥
thười	tʰɯəj˧˨
thườn	tʰɯən˧˨
thường	tʰɯəŋ˧˨
thưởng	tʰɯəŋ˧˩˨
thưỡi	tʰɯəj˧ˀ˥
thưỡn	tʰɯən˧ˀ˥
thược	tʰɯək˨ˀ˩
thượng	tʰɯəŋ˨ˀ˩ʔ
thượt	tʰɯət˨ˀ˩
thạc	tʰak˨ˀ˩
thạch	tʰɛk˨ˀ˩
thạnh	tʰɛŋ˨ˀ˩ʔ
thạo	tʰaw˨ˀ˩ʔ
thạp	tʰap˨ˀ˩
thả	tʰa˧˩˨
thải	tʰaj˧˩˨
thảm	tʰam˧˩˨
thản	tʰan˧˩˨
thảng	tʰaŋ˧˩˨
thảnh	tʰɛŋ˧˩˨
thảo	tʰaw˧˩˨
thảy	tʰăj˧˩˨
thấm	tʰɤ̆m˨˦
thấp	tʰɤ̆p˦˥
thất	tʰɤ̆t˦˥
thấu	tʰɤ̆w˨˦
thấy	tʰɤ̆j˨˦
thầm	tʰɤ̆m˧˨
thần	tʰɤ̆n˧˨
thầu	tʰɤ̆w˧˨
thầy	tʰɤ̆j˧˨
thẩm	tʰɤ̆m˧˩˨
thẩn	tʰɤ̆n˧˩˨
thẩu	tʰɤ̆w˧˩˨
thẩy	tʰɤ̆j˧˩˨
thẫm	tʰɤ̆m˧ˀ˥
thẫn	tʰɤ̆n˧ˀ˥
thậm	tʰɤ̆m˨ˀ˩ʔ
thận	tʰɤ̆n˨ˀ˩ʔ
thập	tʰɤ̆p˨ˀ˩
thật	tʰɤ̆t˨ˀ˩
thắc	tʰăk˦˥
thắm	tʰăm˨˦
thắn	tʰăn˨˦
thắng	tʰăŋ˨˦
thắp	tʰăp˦˥
thắt	tʰăt˦˥
thằn	tʰăn˧˨
thằng	tʰăŋ˧˨
thẳm	tʰăm˧˩˨
thẳng	tʰăŋ˧˩˨
thặng	tʰăŋ˨ˀ˩ʔ
thẹn	tʰɛn˨ˀ˩ʔ
thẹo	tʰeo˨ˀ˩ʔ
thẹp	tʰɛp˨ˀ˩
thẻ	tʰɛ˧˩˨
thẻn	tʰɛn˧˩˨
thẻo	tʰeo˧˩˨
thẽ	tʰɛ˧ˀ˥
thế	tʰe˨˦
thếch	tʰek˦˥
thếp	tʰep˦˥
thết	tʰet˦˥
thề	tʰe˧˨
thềm	tʰem˧˨
thều	tʰɛu˧˨
thể	tʰe˧˩˨
thểu	tʰɛu˧˩˨
thệ	tʰe˨ˀ˩ʔ
thện	tʰen˨ˀ˩ʔ
thỉ	tʰi˧˩˨
thỉnh	tʰiŋ˧˩˨
thỉu	tʰiw˧˩˨
thị	tʰi˨ˀ˩ʔ
thịch	tʰik˨ˀ˩
thịnh	tʰiŋ˨ˀ˩ʔ
thịt	tʰit˨ˀ˩
thịu	tʰiw˨ˀ˩ʔ
thọ	tʰɔ˨ˀ˩ʔ
thọc	tʰɔk͡p˨ˀ˩
thọt	tʰɔt˨ˀ˩
thỏ	tʰɔ˧˩˨
thỏa	tʰwa˧˩˨
thỏi	tʰɔj˧˩˨
thỏm	tʰɔm˧˩˨
thố	tʰo˨˦
thốc	tʰok͡p˦˥
thối	tʰoj˨˦
thốn	tʰon˨˦
thống	tʰoŋ͡m˨˦
thốt	tʰot˦˥
thồ	tʰo˧˨
thồi	tʰoj˧˨
thồm	tʰom˧˨
thồn	tʰon˧˨
thổ	tʰo˧˩˨
thổi	tʰoj˧˩˨
thổn	tʰon˧˩˨
thỗn	tʰon˧ˀ˥
thộc	tʰok͡p˨ˀ˩
thộn	tʰon˨ˀ˩ʔ
thộp	tʰop˨ˀ˩
thột	tʰot˨ˀ˩
thớ	tʰɤ˨˦
thới	tʰɤj˨˦
thớm	tʰɤm˨˦
thớt	tʰɤt˦˥
thờ	tʰɤ˧˨
thời	tʰɤj˧˨
thờm	tʰɤm˧˨
thờn	tʰɤn˧˨
thở	tʰɤ˧˩˨
thợ	tʰɤ˨ˀ˩ʔ
thợt	tʰɤt˨ˀ˩
thụ	tʰu˨ˀ˩ʔ
thục	tʰuk͡p˨ˀ˩
thụi	tʰuj˨ˀ˩ʔ
thụng	tʰuŋ͡m˨ˀ˩ʔ
thụp	tʰup˨ˀ˩
thụt	tʰut˨ˀ˩
thụy	tʰwi˨ˀ˩ʔ
thủ	tʰu˧˩˨
thủa	tʰuə˧˩˨
thủi	tʰuj˧˩˨
thủm	tʰum˧˩˨
thủng	tʰuŋ͡m˧˩˨
thủy	tʰwi˧˩˨
thứ	tʰɯ˨˦
thức	tʰɯk˦˥
thừ	tʰɯ˧˨
thừa	tʰɯə˧˨
thừng	tʰɯŋ˧˨
thử	tʰɯ˧˩˨
thửa	tʰɯə˧˩˨
thửng	tʰɯŋ˧˩˨
thững	tʰɯŋ˧ˀ˥
thự	tʰɯ˨ˀ˩ʔ
thực	tʰɯk˨ˀ˩
ti	ti˧˧
tia	tiə˧˧
tic	tik˧˧
tim	tim˧˧
tin	tin˧˧
ting	tiŋ˧˧
tinh	tiŋ˧˧
tit	tit˧˧
tiu	tiw˧˧
tiêm	tiəm˧˧
tiên	tiən˧˧
tiêng	tiəŋ˧˧
tiêu	tiəw˧˧
tiếc	tiək˦˥
tiếm	tiəm˨˦
tiến	tiən˨˦
tiếng	tiəŋ˨˦
tiếp	tiəp˦˥
tiết	tiət˦˥
tiếu	tiəw˨˦
tiềm	tiəm˧˨
tiền	tiən˧˨
tiều	tiəw˧˨
tiểu	tiəw˧˩˨
tiễn	tiən˧ˀ˥
tiễu	tiəw˧ˀ˥
tiệc	tiək˨ˀ˩
tiệm	tiəm˨ˀ˩ʔ
tiện	tiən˨ˀ˩ʔ
tiệp	tiəp˨ˀ˩
tiệt	tiət˨ˀ˩
to	tɔ˧˧
toa	twa˧˧
toan	twan˧˧
toang	twaŋ˧˧
toanh	twɛŋ˧˧
toe	twe˧˧
toen	twen˧˧
toi	tɔj˧˧
tom	tɔm˧˧
ton	tɔn˧˧
tong	tɔŋ͡m˧˧
toong	tɔɔŋ͡m˧˧
top	tɔp˧˧
toà	twa˧˨
toài	twaj˧˨
toàn	twan˧˨
toàng	twaŋ˧˨
toá	twa˨˦
toác	twak˦˥
toái	twaj˨˦
toán	twan˨˦
toáng	twaŋ˨˦
toát	twat˦˥
toáy	twăj˨˦
toè	twe˧˨
toèn	twen˧˨
toé	twe˨˦
toét	twet˦˥
toòng	tɔɔŋ͡m˧˨
toóc	tɔɔk͡p˦˥
toạ	twa˨ˀ˩ʔ
toạc	twak˨ˀ˩
toại	twaj˨ˀ˩ʔ
toạng	twaŋ˨ˀ˩ʔ
toả	twa˧˩˨
toản	twan˧˩˨
toẹt	twet˨ˀ˩
toẻ	twe˧˩˨
toẽ	twe˧ˀ˥
tra	ca˧˧
trai	caj˧˧
tram	cam˧˧
tran	can˧˧
trang	caŋ˧˧
tranh	cɛŋ˧˧
trao	caw˧˧
trat	cat˧˧
trau	căw˧˧
tre	cɛ˧˧
treng	cɛŋ˧˧
treo	ceo˧˧
tri	ci˧˧
trinh	ciŋ˧˧
triêng	ciəŋ˧˧
triêu	ciəw˧˧
triến	ciən˨˦
triết	ciət˦˥
triền	ciən˧˨
triềng	ciəŋ˧˨
triều	ciəw˧˨
triển	ciən˧˩˨
triện	ciən˨ˀ˩ʔ
triệng	ciəŋ˨ˀ˩ʔ
triệt	ciət˨ˀ˩
triệu	ciəw˨ˀ˩ʔ
tro	cɔ˧˧
troi	cɔj˧˧
trom	cɔm˧˧
tron	cɔn˧˧
trong	cɔŋ͡m˧˧
troẹt	cwet˨ˀ˩
tru	cu˧˧
trui	cuj˧˧
trun	cun˧˧
trung	cuŋ͡m˧˧
truy	cwi˧˧
truyền	cwiən˧˨
truyện	cwiən˨ˀ˩ʔ
truân	cwɤ̆n˧˧
truông	cuəŋ˧˧
truất	cwɤ̆t˦˥
truật	cwɤ̆t˨ˀ˩
truồi	cuəj˧˨
truồng	cuəŋ˧˨
truột	cuət˨ˀ˩
truờng	cuəŋ˧˨
truỵ	cwi˨ˀ˩ʔ
trà	ca˧˨
trài	caj˧˨
tràm	cam˧˨
tràn	can˧˨
tràng	caŋ˧˨
trành	cɛŋ˧˨
trào	caw˧˨
tràu	căw˧˨
trày	căj˧˨
trá	ca˨˦
trác	cak˦˥
trách	cɛk˦˥
trái	caj˨˦
trám	cam˨˦
trán	can˨˦
tráng	caŋ˨˦
tránh	cɛŋ˨˦
tráo	caw˨˦
tráp	cap˦˥
trát	cat˦˥
trâm	cɤ̆m˧˧
trân	cɤ̆n˧˧
trâng	cɤ̆ŋ˧˧
trâu	cɤ̆w˧˧
trây	cɤ̆j˧˧
trã	ca˧ˀ˥
trãi	caj˧ˀ˥
trè	cɛ˧˨
trèm	cɛm˧˨
trèn	cɛn˧˨
trèo	ceo˧˨
tréc	cɛk˦˥
trém	cɛm˨˦
tréo	ceo˨˦
trét	cɛt˦˥
trê	ce˧˧
trên	cen˧˧
trêu	cɛu˧˧
trì	ci˧˨
trình	ciŋ˧˨
trìu	ciw˧˨
trí	ci˨˦
tría	ciə˨˦
trích	cik˦˥
trính	ciŋ˨˦
trít	cit˦˥
tríu	ciw˨˦
trò	cɔ˧˨
tròi	cɔj˧˨
tròm	cɔm˧˨
tròn	cɔn˧˨
tròng	cɔŋ͡m˧˨
tróc	cɔk͡p˦˥
trói	cɔj˨˦
tróm	cɔm˨˦
tróng	cɔŋ͡m˨˦
trót	cɔt˦˥
trô	co˧˧
trôi	coj˧˧
trôm	com˧˧
trôn	con˧˧
trông	coŋ͡m˧˧
trõm	cɔm˧ˀ˥
trõn	cɔn˧ˀ˥
trù	cu˧˨
trùi	cuj˧˨
trùm	cum˧˨
trùn	cun˧˨
trùng	cuŋ͡m˧˨
trú	cu˨˦
trúc	cuk͡p˦˥
trúm	cum˨˦
trúng	cuŋ͡m˨˦
trút	cut˦˥
trăm	căm˧˧
trăn	căn˧˧
trăng	căŋ˧˧
trĩ	ci˧ˀ˥
trĩnh	ciŋ˧ˀ˥
trĩu	ciw˧ˀ˥
trũi	cuj˧ˀ˥
trũng	cuŋ͡m˧ˀ˥
trơ	cɤ˧˧
trơi	cɤj˧˧
trơn	cɤn˧˧
trưa	cɯə˧˧
trưng	cɯŋ˧˧
trương	cɯəŋ˧˧
trước	cɯək˦˥
trướng	cɯəŋ˨˦
trườn	cɯən˧˨
trường	cɯəŋ˧˨
trưởng	cɯəŋ˧˩˨
trưỡng	cɯəŋ˧ˀ˥
trượng	cɯəŋ˨ˀ˩ʔ
trượt	cɯət˨ˀ˩
trạc	cak˨ˀ˩
trạch	cɛk˨ˀ˩
trại	caj˨ˀ˩ʔ
trạm	cam˨ˀ˩ʔ
trạn	can˨ˀ˩ʔ
trạng	caŋ˨ˀ˩ʔ
trạnh	cɛŋ˨ˀ˩ʔ
trạo	caw˨ˀ˩ʔ
trạt	cat˨ˀ˩
trạy	căj˨ˀ˩ʔ
trả	ca˧˩˨
trải	caj˧˩˨
trảm	cam˧˩˨
trản	can˧˩˨
trảng	caŋ˧˩˨
trảnh	cɛŋ˧˩˨
trảo	caw˧˩˨
trảu	căw˧˩˨
trảy	căj˧˩˨
trấn	cɤ̆n˨˦
trấp	cɤ̆p˦˥
trất	cɤ̆t˦˥
trấu	cɤ̆w˨˦
trầm	cɤ̆m˧˨
trần	cɤ̆n˧˨
trầu	cɤ̆w˧˨
trầy	cɤ̆j˧˨
trẩm	cɤ̆m˧˩˨
trẩn	cɤ̆n˧˩˨
trẩu	cɤ̆w˧˩˨
trẩy	cɤ̆j˧˩˨
trẫm	cɤ̆m˧ˀ˥
trậm	cɤ̆m˨ˀ˩ʔ
trận	cɤ̆n˨ˀ˩ʔ
trập	cɤ̆p˨ˀ˩
trật	cɤ̆t˨ˀ˩
trắc	căk˦˥
trắm	căm˨˦
trắng	căŋ˨˦
trắt	căt˦˥
trằm	căm˧˨
trằn	căn˧˨
trằng	căŋ˧˨
trẳng	căŋ˧˩˨
trặc	căk˨ˀ˩
trặn	căn˨ˀ˩ʔ
trẹ	cɛ˨ˀ˩ʔ
trẹo	ceo˨ˀ˩ʔ
trẹt	cɛt˨ˀ˩
trẻ	cɛ˧˩˨
trẻo	ceo˧˩˨
trẽ	cɛ˧ˀ˥
trẽn	cɛn˧ˀ˥
trẽo	ceo˧ˀ˥
trếch	cek˦˥
trếnh	ceŋ˨˦
trết	cet˦˥
trếu	cɛu˨˦
trề	ce˧˨
trển	cen˧˩˨
trễ	ce˧ˀ˥
trệ	ce˨ˀ˩ʔ
trệch	cek˨ˀ˩
trệt	cet˨ˀ˩
trệu	cɛu˨ˀ˩ʔ
trỉa	ciə˧˩˨
trị	ci˨ˀ˩ʔ
trịa	ciə˨ˀ˩ʔ
trịch	cik˨ˀ˩
trịnh	ciŋ˨ˀ˩ʔ
trịt	cit˨ˀ˩
trọ	cɔ˨ˀ˩ʔ
trọc	cɔk͡p˨ˀ˩
trọi	cɔj˨ˀ˩ʔ
trọn	cɔn˨ˀ˩ʔ
trọng	cɔŋ͡m˨ˀ˩ʔ
trọt	cɔt˨ˀ˩
trỏ	cɔ˧˩˨
trỏi	cɔj˧˩˨
trỏng	cɔŋ͡m˧˩˨
trố	co˨˦
trốc	cok͡p˦˥
trối	coj˨˦
trốn	con˨˦
trống	coŋ͡m˨˦
trốt	cot˦˥
trồ	co˧˨
trồi	coj˧˨
trồng	coŋ͡m˧˨
trổ	co˧˩˨
trổi	coj˧˩˨
trổng	coŋ͡m˧˩˨
trỗ	co˧ˀ˥
trỗi	coj˧ˀ˥
trộ	co˨ˀ˩ʔ
trộc	cok͡p˨ˀ˩
trội	coj˨ˀ˩ʔ
trộm	com˨ˀ˩ʔ
trộn	con˨ˀ˩ʔ
trộng	coŋ͡m˨ˀ˩ʔ
trớ	cɤ˨˦
trới	cɤj˨˦
trớn	cɤn˨˦
trớp	cɤp˦˥
trớt	cɤt˦˥
trờ	cɤ˧˨
trời	cɤj˧˨
trờm	cɤm˧˨
trờn	cɤn˧˨
trở	cɤ˧˩˨
trợ	cɤ˨ˀ˩ʔ
trợn	cɤn˨ˀ˩ʔ
trợt	cɤt˨ˀ˩
trụ	cu˨ˀ˩ʔ
trụa	cuə˨ˀ˩ʔ
trục	cuk͡p˨ˀ˩
trụi	cuj˨ˀ˩ʔ
trụm	cum˨ˀ˩ʔ
trụn	cun˨ˀ˩ʔ
trụng	cuŋ͡m˨ˀ˩ʔ
trụp	cup˨ˀ˩
trụt	cut˨ˀ˩
trụy	cwi˨ˀ˩ʔ
trủ	cu˧˩˨
trủng	cuŋ͡m˧˩˨
trứ	cɯ˨˦
trứng	cɯŋ˨˦
trừ	cɯ˧˨
trừa	cɯə˧˨
trừng	cɯŋ˧˨
trừu	cɯw˧˨
trửng	cɯŋ˧˩˨
trữ	cɯ˧ˀ˥
trự	cɯ˨ˀ˩ʔ
trực	cɯk˨ˀ˩
tu	tu˧˧
tua	tuə˧˧
tui	tuj˧˧
tum	tum˧˧
tun	tun˧˧
tung	tuŋ͡m˧˧
tuy	twi˧˧
tuya	twiə˧˧
tuyn	twin˧˧
tuyên	twiən˧˧
tuyếc	twiək˦˥
tuyến	twiən˨˦
tuyết	twiət˦˥
tuyền	twiən˧˨
tuyển	twiən˧˩˨
tuyệt	twiət˨ˀ˩
tuân	twɤ̆n˧˧
tuôn	tuən˧˧
tuông	tuəŋ˧˧
tuý	twi˨˦
tuýp	twip˦˥
tuýt	twit˦˥
tuấn	twɤ̆n˨˦
tuất	twɤ̆t˦˥
tuần	twɤ̆n˧˨
tuẫn	twɤ̆n˧ˀ˥
tuế	twe˨˦
tuếch	twek˦˥
tuềnh	tweŋ˧˨
tuệ	twe˨ˀ˩ʔ
tuệch	twek˨ˀ˩
tuốc	tuək˦˥
tuốn	tuən˨˦
tuốt	tuət˦˥
tuồi	tuəj˧˨
tuồn	tuən˧˨
tuồng	tuəŋ˧˨
tuổi	tuəj˧˩˨
tuộc	tuək˨ˀ˩
tuột	tuət˨ˀ˩
tuỳ	twi˧˨
tuỵ	twi˨ˀ˩ʔ
tuỷ	twi˧˩˨
ty	ti˧˧
tà	ta˧˨
tài	taj˧˨
tàm	tam˧˨
tàn	tan˧˨
tàng	taŋ˧˨
tành	tɛŋ˧˨
tào	taw˧˨
tàu	tăw˧˨
tày	tăj˧˨
tá	ta˨˦
tác	tak˦˥
tách	tɛk˦˥
tái	taj˨˦
tám	tam˨˦
tán	tan˨˦
táng	taŋ˨˦
tánh	tɛŋ˨˦
táo	taw˨˦
táp	tap˦˥
tát	tat˦˥
táu	tăw˨˦
táy	tăj˨˦
tâm	tɤ̆m˧˧
tân	tɤ̆n˧˧
tâng	tɤ̆ŋ˧˧
tâu	tɤ̆w˧˧
tây	tɤ̆j˧˧
tã	ta˧ˀ˥
tãi	taj˧ˀ˥
tè	tɛ˧˨
tèm	tɛm˧˨
tèn	tɛn˧˨
tèng	tɛŋ˧˨
tèo	teo˧˨
té	tɛ˨˦
téc	tɛk˦˥
tém	tɛm˨˦
tén	tɛn˨˦
téo	teo˨˦
tép	tɛp˦˥
tét	tɛt˦˥
tê	te˧˧
têm	tem˧˧
tên	ten˧˧
tênh	teŋ˧˧
têt	tet˧˧
têu	tɛu˧˧
tì	ti˧˨
tìm	tim˧˨
tình	tiŋ˧˨
tí	ti˨˦
tía	tiə˨˦
tíc	tik˦˥
tích	tik˦˥
tím	tim˨˦
tín	tin˨˦
tính	tiŋ˨˦
típ	tip˦˥
tít	tit˦˥
tíu	tiw˨˦
tò	tɔ˧˨
tòa	twa˧˨
tòe	twe˧˨
tòi	tɔj˧˨
tòm	tɔm˧˨
tòn	tɔn˧˨
tòng	tɔŋ͡m˧˨
tó	tɔ˨˦
tóc	tɔk͡p˦˥
tóe	twe˨˦
tói	tɔj˨˦
tóm	tɔm˨˦
tóp	tɔp˦˥
tót	tɔt˦˥
tô	to˧˧
tôi	toj˧˧
tôm	tom˧˧
tôn	ton˧˧
tông	toŋ͡m˧˧
tõm	tɔm˧ˀ˥
tù	tu˧˨
tùm	tum˧˨
tùng	tuŋ͡m˧˨
tùy	twi˧˨
tú	tu˨˦
túa	tuə˨˦
túc	tuk͡p˦˥
túi	tuj˨˦
túm	tum˨˦
túng	tuŋ͡m˨˦
túp	tup˦˥
tút	tut˦˥
túy	twi˨˦
tý	ti˨˦
tăm	tăm˧˧
tăn	tăn˧˧
tăng	tăŋ˧˧
tĩ	ti˧ˀ˥
tĩn	tin˧ˀ˥
tĩnh	tiŋ˧ˀ˥
tĩu	tiw˧ˀ˥
tũm	tum˧ˀ˥
tũn	tun˧ˀ˥
tơ	tɤ˧˧
tơi	tɤj˧˧
tơn	tɤn˧˧
tư	tɯ˧˧
tưa	tɯə˧˧
tưng	tɯŋ˧˧
tươi	tɯəj˧˧
tươm	tɯəm˧˧
tương	tɯəŋ˧˧
tước	tɯək˦˥
tưới	tɯəj˨˦
tướn	tɯən˨˦
tướng	tɯəŋ˨˦
tướp	tɯəp˦˥
tướt	tɯət˦˥
tườm	tɯəm˧˨
tường	tɯəŋ˧˨
tườu	tɯəw˧˨
tưởi	tɯəj˧˩˨
tưởng	tɯəŋ˧˩˨
tược	tɯək˨ˀ˩
tượng	tɯəŋ˨ˀ˩ʔ
tượp	tɯəp˨ˀ˩
tượt	tɯət˨ˀ˩
tạ	ta˨ˀ˩ʔ
tạc	tak˨ˀ˩
tạch	tɛk˨ˀ˩
tại	taj˨ˀ˩ʔ
tạm	tam˨ˀ˩ʔ
tạng	taŋ˨ˀ˩ʔ
tạnh	tɛŋ˨ˀ˩ʔ
tạo	taw˨ˀ˩ʔ
tạp	tap˨ˀ˩
tạt	tat˨ˀ˩
tả	ta˧˩˨
tải	taj˧˩˨
tản	tan˧˩˨
tảng	taŋ˧˩˨
tảo	taw˧˩˨
tấc	tɤ̆k˦˥
tấm	tɤ̆m˨˦
tấn	tɤ̆n˨˦
tấp	tɤ̆p˦˥
tất	tɤ̆t˦˥
tấu	tɤ̆w˨˦
tấy	tɤ̆j˨˦
tầm	tɤ̆m˧˨
tần	tɤ̆n˧˨
tầng	tɤ̆ŋ˧˨
tầu	tɤ̆w˧˨
tầy	tɤ̆j˧˨
tẩm	tɤ̆m˧˩˨
tẩn	tɤ̆n˧˩˨
tẩu	tɤ̆w˧˩˨
tẩy	tɤ̆j˧˩˨
tậm	tɤ̆m˨ˀ˩ʔ
tận	tɤ̆n˨ˀ˩ʔ
tập	tɤ̆p˨ˀ˩
tật	tɤ̆t˨ˀ˩
tậu	tɤ̆w˨ˀ˩ʔ
tắc	tăk˦˥
tắm	tăm˨˦
tắn	tăn˨˦
tắp	tăp˦˥
tắt	tăt˦˥
tằm	tăm˧˨
tằn	tăn˧˨
tằng	tăŋ˧˨
tẳn	tăn˧˩˨
tặc	tăk˨ˀ˩
tặn	tăn˨ˀ˩ʔ
tặng	tăŋ˨ˀ˩ʔ
tẹc	tɛk˨ˀ˩
tẹo	teo˨ˀ˩ʔ
tẹp	tɛp˨ˀ˩
tẹt	tɛt˨ˀ˩
tẻ	tɛ˧˩˨
tẻm	tɛm˧˩˨
tẻo	teo˧˩˨
tẽ	tɛ˧ˀ˥
tẽn	tɛn˧ˀ˥
tế	te˨˦
tếch	tek˦˥
tết	tet˦˥
tếu	tɛu˨˦
tề	te˧˨
tềnh	teŋ˧˨
tể	te˧˩˨
tểnh	teŋ˧˩˨
tễ	te˧ˀ˥
tễnh	teŋ˧ˀ˥
tệ	te˨ˀ˩ʔ
tệp	tep˨ˀ˩
tỉ	ti˧˩˨
tỉa	tiə˧˩˨
tỉm	tim˧˩˨
tỉnh	tiŋ˧˩˨
tỉu	tiw˧˩˨
tị	ti˨ˀ˩ʔ
tịch	tik˨ˀ˩
tịnh	tiŋ˨ˀ˩ʔ
tịt	tit˨ˀ˩
tịu	tiw˨ˀ˩ʔ
tọ	tɔ˨ˀ˩ʔ
tọa	twa˨ˀ˩ʔ
tọc	tɔk͡p˨ˀ˩
tọng	tɔŋ͡m˨ˀ˩ʔ
tọp	tɔp˨ˀ˩
tọt	tɔt˨ˀ˩
tỏ	tɔ˧˩˨
tỏa	twa˧˩˨
tỏe	twe˧˩˨
tỏi	tɔj˧˩˨
tỏm	tɔm˧˩˨
tỏng	tɔŋ͡m˧˩˨
tố	to˨˦
tốc	tok͡p˦˥
tối	toj˨˦
tốn	ton˨˦
tống	toŋ͡m˨˦
tốp	top˦˥
tốt	tot˦˥
tồ	to˧˨
tồi	toj˧˨
tồm	tom˧˨
tồn	ton˧˨
tồng	toŋ͡m˧˨
tổ	to˧˩˨
tổn	ton˧˩˨
tổng	toŋ͡m˧˩˨
tỗng	toŋ͡m˧ˀ˥
tộ	to˨ˀ˩ʔ
tộc	tok͡p˨ˀ˩
tội	toj˨ˀ˩ʔ
tộp	top˨ˀ˩
tột	tot˨ˀ˩
tớ	tɤ˨˦
tới	tɤj˨˦
tớn	tɤn˨˦
tớp	tɤp˦˥
tớt	tɤt˦˥
tờ	tɤ˧˨
tời	tɤj˧˨
tở	tɤ˧˩˨
tởm	tɤm˧˩˨
tởn	tɤn˧˩˨
tợ	tɤ˨ˀ˩ʔ
tợn	tɤn˨ˀ˩ʔ
tợp	tɤp˨ˀ˩
tụ	tu˨ˀ˩ʔ
tục	tuk͡p˨ˀ˩
tụi	tuj˨ˀ˩ʔ
tụm	tum˨ˀ˩ʔ
tụng	tuŋ͡m˨ˀ˩ʔ
tụt	tut˨ˀ˩
tụy	twi˨ˀ˩ʔ
tủ	tu˧˩˨
tủa	tuə˧˩˨
tủi	tuj˧˩˨
tủm	tum˧˩˨
tủn	tun˧˩˨
tủng	tuŋ͡m˧˩˨
tủy	twi˧˩˨
tứ	tɯ˨˦
tứa	tɯə˨˦
tức	tɯk˦˥
từ	tɯ˧˨
từa	tɯə˧˨
từng	tɯŋ˧˨
tử	tɯ˧˩˨
tửa	tɯə˧˩˨
tửng	tɯŋ˧˩˨
tửu	tɯw˧˩˨
tự	tɯ˨ˀ˩ʔ
tựa	tɯə˨ˀ˩ʔ
tựu	tɯw˨ˀ˩ʔ
tỳ	ti˧˨
tỵ	ti˨ˀ˩ʔ
tỷ	ti˧˩˨
u	u˧˧
ui	uj˧˧
um	um˧˧
un	un˧˧
ung	uŋ͡m˧˧
uy	wi˧˧
uyn	win˧˧
uyên	wiən˧˧
uyển	wiən˧˩˨
uôm	uəm˧˧
uông	uəŋ˧˧
uý	wi˨˦
uất	wɤ̆t˦˥
uầy	wɤ̆j˧˨
uẩn	wɤ̆n˧˩˨
uẩy	wɤ̆j˧˩˨
uế	we˨˦
uể	we˧˩˨
uốn	uən˨˦
uống	uəŋ˨˦
uổng	uəŋ˧˩˨
uột	uət˨ˀ˩
uở	uə˧˩˨
uỳnh	wiŋ˧˨
uỵch	wik˨ˀ˩
uỷ	wi˧˩˨
va	va˧˧
vac	vak˧˧
vai	vaj˧˧
vam	vam˧˧
van	van˧˧
vang	vaŋ˧˧
vanh	vɛŋ˧˧
vao	vaw˧˧
vay	văj˧˧
ve	vɛ˧˧
ven	vɛn˧˧
veo	veo˧˧
vi	vi˧˧
via	viə˧˧
vin	vin˧˧
vinh	viŋ˧˧
viêm	viəm˧˧
viên	viən˧˧
viêng	viəŋ˧˧
viếng	viəŋ˨˦
viết	viət˦˥
viền	viən˧˨
viển	viən˧˩˨
viễn	viən˧ˀ˥
việc	viək˨ˀ˩
viện	viən˨ˀ˩ʔ
việt	viət˨ˀ˩
vo	vɔ˧˧
voa	vwa˧˧
voan	vwan˧˧
voi	vɔj˧˧
vom	vɔm˧˧
von	vɔn˧˧
vong	vɔŋ͡m˧˧
voọc	vɔɔk͡p˨ˀ˩
vu	vu˧˧
vua	vuə˧˧
vui	vuj˧˧
vun	vun˧˧
vung	vuŋ͡m˧˧
vuông	vuəŋ˧˧
vuốt	vuət˦˥
vuột	vuət˨ˀ˩
vy	vi˧˧
và	va˧˨
vài	vaj˧˨
vàm	vam˧˨
vàn	van˧˨
vàng	vaŋ˧˨
vành	vɛŋ˧˨
vào	vaw˧˨
vày	văj˧˨
vá	va˨˦
vác	vak˦˥
vách	vɛk˦˥
vái	vaj˨˦
ván	van˨˦
váng	vaŋ˨˦
vánh	vɛŋ˨˦
váo	vaw˨˦
váp	vap˦˥
vát	vat˦˥
váy	văj˨˦
vâm	vɤ̆m˧˧
vân	vɤ̆n˧˧
vâng	vɤ̆ŋ˧˧
vây	vɤ̆j˧˧
vã	va˧ˀ˥
vãi	vaj˧ˀ˥
vãn	van˧ˀ˥
vãng	vaŋ˧ˀ˥
vãnh	vɛŋ˧ˀ˥
vè	vɛ˧˨
vèo	veo˧˨
vé	vɛ˨˦
véc	vɛk˦˥
vén	vɛn˨˦
véo	veo˨˦
vét	vɛt˦˥
vê	ve˧˧
vên	ven˧˧
vênh	veŋ˧˧
vêu	vɛu˧˧
vì	vi˧˨
ví	vi˨˦
vía	viə˨˦
vích	vik˦˥
vính	viŋ˨˦
vít	vit˦˥
víu	viw˨˦
vò	vɔ˧˨
vòi	vɔj˧˨
vòm	vɔm˧˨
vòn	vɔn˧˨
vòng	vɔŋ͡m˧˨
vó	vɔ˨˦
vóc	vɔk͡p˦˥
vói	vɔj˨˦
vón	vɔn˨˦
vóng	vɔŋ͡m˨˦
vót	vɔt˦˥
vô	vo˧˧
vôi	voj˧˧
vôn	von˧˧
vông	voŋ͡m˧˧
võ	vɔ˧ˀ˥
võng	vɔŋ͡m˧ˀ˥
vù	vu˧˨
vùa	vuə˧˨
vùi	vuj˧˨
vùn	vun˧˨
vùng	vuŋ͡m˧˨
vú	vu˨˦
vúc	vuk͡p˦˥
vút	vut˦˥
văn	văn˧˧
văng	văŋ˧˧
vĩ	vi˧ˀ˥
vĩnh	viŋ˧ˀ˥
vũ	vu˧ˀ˥
vũm	vum˧ˀ˥
vũng	vuŋ͡m˧ˀ˥
vơ	vɤ˧˧
vơi	vɤj˧˧
vưng	vɯŋ˧˧
vưu	vɯw˧˧
vươn	vɯən˧˧
vương	vɯəŋ˧˧
vướng	vɯəŋ˨˦
vườn	vɯən˧˨
vưởng	vɯəŋ˧˩˨
vược	vɯək˨ˀ˩
vượn	vɯən˨ˀ˩ʔ
vượng	vɯəŋ˨ˀ˩ʔ
vượt	vɯət˨ˀ˩
vạ	va˨ˀ˩ʔ
vạc	vak˨ˀ˩
vạch	vɛk˨ˀ˩
vại	vaj˨ˀ˩ʔ
vạm	vam˨ˀ˩ʔ
vạn	van˨ˀ˩ʔ
vạng	vaŋ˨ˀ˩ʔ
vạnh	vɛŋ˨ˀ˩ʔ
vạp	vap˨ˀ˩
vạt	vat˨ˀ˩
vạy	văj˨ˀ˩ʔ
vả	va˧˩˨
vải	vaj˧˩˨
vảng	vaŋ˧˩˨
vảnh	vɛŋ˧˩˨
vảy	văj˧˩˨
vấn	vɤ̆n˨˦
vấp	vɤ̆p˦˥
vất	vɤ̆t˦˥
vấu	vɤ̆w˨˦
vấy	vɤ̆j˨˦
vần	vɤ̆n˧˨
vầng	vɤ̆ŋ˧˨
vầu	vɤ̆w˧˨
vầy	vɤ̆j˧˨
vẩn	vɤ̆n˧˩˨
vẩu	vɤ̆w˧˩˨
vẩy	vɤ̆j˧˩˨
vẫn	vɤ̆n˧ˀ˥
vẫy	vɤ̆j˧ˀ˥
vậm	vɤ̆m˨ˀ˩ʔ
vận	vɤ̆n˨ˀ˩ʔ
vập	vɤ̆p˨ˀ˩
vật	vɤ̆t˨ˀ˩
vậy	vɤ̆j˨ˀ˩ʔ
vắc	văk˦˥
vắn	văn˨˦
vắng	văŋ˨˦
vắt	văt˦˥
vằm	văm˧˨
vằn	văn˧˨
vằng	văŋ˧˨
vẳng	văŋ˧˩˨
vặc	văk˨ˀ˩
vặn	văn˨ˀ˩ʔ
vặt	văt˨ˀ˩
vẹc	vɛk˨ˀ˩
vẹm	vɛm˨ˀ˩ʔ
vẹn	vɛn˨ˀ˩ʔ
vẹo	veo˨ˀ˩ʔ
vẹt	vɛt˨ˀ˩
vẻ	vɛ˧˩˨
vẻn	vɛn˧˩˨
vẻo	veo˧˩˨
vẽ	vɛ˧ˀ˥
vế	ve˨˦
vếch	vek˦˥
vết	vet˦˥
vếu	vɛu˨˦
về	ve˧˨
vền	ven˧˨
vều	vɛu˧˨
vểnh	veŋ˧˩˨
vệ	ve˨ˀ˩ʔ
vện	ven˨ˀ˩ʔ
vệt	vet˨ˀ˩
vỉ	vi˧˩˨
vỉa	viə˧˩˨
vị	vi˨ˀ˩ʔ
vịm	vim˨ˀ˩ʔ
vịn	vin˨ˀ˩ʔ
vịnh	viŋ˨ˀ˩ʔ
vịt	vit˨ˀ˩
vọ	vɔ˨ˀ˩ʔ
vọc	vɔk͡p˨ˀ˩
vọi	vɔj˨ˀ˩ʔ
vọng	vɔŋ͡m˨ˀ˩ʔ
vọp	vɔp˨ˀ˩
vọt	vɔt˨ˀ˩
vỏ	vɔ˧˩˨
vỏn	vɔn˧˩˨
vỏng	vɔŋ͡m˧˩˨
vố	vo˨˦
vốc	vok͡p˦˥
vối	voj˨˦
vốn	von˨˦
vống	voŋ͡m˨˦
vồ	vo˧˨
vồi	voj˧˨
vồn	von˧˨
vồng	voŋ͡m˧˨
vổ	vo˧˩˨
vổng	voŋ͡m˧˩˨
vỗ	vo˧ˀ˥
vội	voj˨ˀ˩ʔ
vớ	vɤ˨˦
với	vɤj˨˦
vớt	vɤt˦˥
vờ	vɤ˧˨
vời	vɤj˧˨
vờn	vɤn˧˨
vở	vɤ˧˩˨
vởn	vɤn˧˩˨
vỡ	vɤ˧ˀ˥
vợ	vɤ˨ˀ˩ʔ
vợi	vɤj˨ˀ˩ʔ
vợt	vɤt˨ˀ˩
vụ	vu˨ˀ˩ʔ
vục	vuk͡p˨ˀ˩
vụn	vun˨ˀ˩ʔ
vụng	vuŋ͡m˨ˀ˩ʔ
vụt	vut˨ˀ˩
vủn	vun˧˩˨
vức	vɯk˦˥
vứt	vɯt˦˥
vừa	vɯə˧˨
vừng	vɯŋ˧˨
vửng	vɯŋ˧˩˨
vữa	vɯə˧ˀ˥
vững	vɯŋ˧ˀ˥
vựa	vɯə˨ˀ˩ʔ
vực	vɯk˨ˀ˩
vựng	vɯŋ˨ˀ˩ʔ
xa	sa˧˧
xam	sam˧˧
xan	san˧˧
xang	saŋ˧˧
xanh	sɛŋ˧˧
xao	saw˧˧
xay	săj˧˧
xe	sɛ˧˧
xem	sɛm˧˧
xen	sɛn˧˧
xeng	sɛŋ˧˧
xeo	seo˧˧
xi	si˧˧
xia	siə˧˧
xim	sim˧˧
xin	sin˧˧
xing	siŋ˧˧
xinh	siŋ˧˧
xit	sit˧˧
xiêm	siəm˧˧
xiên	siən˧˧
xiêu	siəw˧˧
xiếc	siək˦˥
xiết	siət˦˥
xiếu	siəw˨˦
xiềng	siəŋ˧˨
xiểm	siəm˧˩˨
xiển	siən˧˩˨
xiểng	siəŋ˧˩˨
xo	sɔ˧˧
xoa	swa˧˧
xoai	swaj˧˧
xoan	swan˧˧
xoang	swaŋ˧˧
xoay	swăj˧˧
xoe	swe˧˧
xoen	swen˧˧
xoi	sɔj˧˧
xom	sɔm˧˧
xon	sɔn˧˧
xong	sɔŋ͡m˧˧
xoong	sɔɔŋ͡m˧˧
xoà	swa˧˨
xoài	swaj˧˨
xoàm	swam˧˨
xoàn	swan˧˨
xoàng	swaŋ˧˨
xoành	swɛŋ˧˨
xoá	swa˨˦
xoác	swak˦˥
xoát	swat˦˥
xoáy	swăj˨˦
xoã	swa˧ˀ˥
xoè	swe˧˨
xoèn	swen˧˨
xoét	swet˦˥
xoóc	sɔɔk͡p˦˥
xoăn	swăn˧˧
xoạc	swak˨ˀ˩
xoạch	swɛk˨ˀ˩
xoạng	swaŋ˨ˀ˩ʔ
xoạt	swat˨ˀ˩
xoả	swa˧˩˨
xoải	swaj˧˩˨
xoảng	swaŋ˧˩˨
xoắn	swăn˨˦
xoẳn	swăn˧˩˨
xoẹ	swe˨ˀ˩ʔ
xoẹt	swet˨ˀ˩
xoẻng	sweŋ˧˩˨
xu	su˧˧
xua	suə˧˧
xui	suj˧˧
xum	sum˧˧
xun	sun˧˧
xung	suŋ͡m˧˧
xuy	swi˧˧
xuya	swiə˧˧
xuynh	swiŋ˧˧
xuyên	swiən˧˧
xuyến	swiən˨˦
xuyết	swiət˦˥
xuân	swɤ̆n˧˧
xuây	swɤ̆j˧˧
xuê	swe˧˧
xuôi	suəj˧˧
xuý	swi˨˦
xuýt	swit˦˥
xuất	swɤ̆t˦˥
xuẩn	swɤ̆n˧˩˨
xuề	swe˧˨
xuềnh	sweŋ˧˨
xuể	swe˧˩˨
xuệch	swek˨ˀ˩
xuống	suəŋ˨˦
xuồng	suəŋ˧˨
xuổng	suəŋ˧˩˨
xuộm	suəm˨ˀ˩ʔ
xuỳ	swi˧˨
xuỵt	swit˨ˀ˩
xy	si˧˧
xà	sa˧˨
xài	saj˧˨
xàm	sam˧˨
xàng	saŋ˧˨
xành	sɛŋ˧˨
xào	saw˧˨
xàu	săw˧˨
xá	sa˨˦
xác	sak˦˥
xách	sɛk˦˥
xái	saj˨˦
xám	sam˨˦
xán	san˨˦
xáng	saŋ˨˦
xáo	saw˨˦
xáp	sap˦˥
xát	sat˦˥
xáu	săw˨˦
xáy	săj˨˦
xâm	sɤ̆m˧˧
xâu	sɤ̆w˧˧
xây	sɤ̆j˧˧
xã	sa˧ˀ˥
xè	sɛ˧˨
xèn	sɛn˧˨
xèng	sɛŋ˧˨
xèo	seo˧˨
xé	sɛ˨˦
xéc	sɛk˦˥
xém	sɛm˨˦
xén	sɛn˨˦
xéo	seo˨˦
xép	sɛp˦˥
xét	sɛt˦˥
xê	se˧˧
xên	sen˧˧
xênh	seŋ˧˧
xêu	sɛu˧˧
xì	si˧˨
xìa	siə˧˨
xình	siŋ˧˨
xìu	siw˧˨
xí	si˨˦
xía	siə˨˦
xích	sik˦˥
xín	sin˨˦
xính	siŋ˨˦
xít	sit˦˥
xíu	siw˨˦
xòa	swa˧˨
xòe	swe˧˨
xòm	sɔm˧˨
xòng	sɔŋ͡m˧˨
xó	sɔ˨˦
xóa	swa˨˦
xóc	sɔk͡p˦˥
xói	sɔj˨˦
xóm	sɔm˨˦
xón	sɔn˨˦
xóng	sɔŋ͡m˨˦
xóp	sɔp˦˥
xót	sɔt˦˥
xô	so˧˧
xôi	soj˧˧
xôm	som˧˧
xôn	son˧˧
xông	soŋ͡m˧˧
xõa	swa˧ˀ˥
xõm	sɔm˧ˀ˥
xõng	sɔŋ͡m˧ˀ˥
xù	su˧˨
xùa	suə˧˨
xùi	suj˧˨
xùm	sum˧˨
xùng	suŋ͡m˧˨
xùy	swi˧˨
xú	su˨˦
xúa	suə˨˦
xúc	suk͡p˦˥
xúi	suj˨˦
xúm	sum˨˦
xúng	suŋ͡m˨˦
xúp	sup˦˥
xút	sut˦˥
xúy	swi˨˦
xýt	sit˦˥
xăm	săm˧˧
xăn	săn˧˧
xăng	săŋ˧˧
xĩnh	siŋ˧ˀ˥
xũ	su˧ˀ˥
xơ	sɤ˧˧
xơi	sɤj˧˧
xơm	sɤm˧˧
xơn	sɤn˧˧
xưa	sɯə˧˧
xưng	sɯŋ˧˧
xương	sɯəŋ˧˧
xước	sɯək˦˥
xướng	sɯəŋ˨˦
xười	sɯəj˧˨
xường	sɯəŋ˧˨
xưởng	sɯəŋ˧˩˨
xược	sɯək˨ˀ˩
xượi	sɯəj˨ˀ˩ʔ
xượt	sɯət˨ˀ˩
xạ	sa˨ˀ˩ʔ
xạc	sak˨ˀ˩
xạch	sɛk˨ˀ˩
xạm	sam˨ˀ˩ʔ
xạo	saw˨ˀ˩ʔ
xạp	sap˨ˀ˩
xạu	săw˨ˀ˩ʔ
xả	sa˧˩˨
xải	saj˧˩˨
xảm	sam˧˩˨
xảnh	sɛŋ˧˩˨
xảo	saw˧˩˨
xảu	săw˧˩˨
xảy	săj˧˩˨
xấc	sɤ̆k˦˥
xấp	sɤ̆p˦˥
xấu	sɤ̆w˨˦
xầm	sɤ̆m˧˨
xầu	sɤ̆w˧˨
xẩm	sɤ̆m˧˩˨
xẩn	sɤ̆n˧˩˨
xẩu	sɤ̆w˧˩˨
xẩy	sɤ̆j˧˩˨
xậm	sɤ̆m˨ˀ˩ʔ
xập	sɤ̆p˨ˀ˩
xắc	săk˦˥
xắm	săm˨˦
xắn	săn˨˦
xắng	săŋ˨˦
xắp	săp˦˥
xắt	săt˦˥
xằng	săŋ˧˨
xẵng	săŋ˧ˀ˥
xẹ	sɛ˨ˀ˩ʔ
xẹc	sɛk˨ˀ˩
xẹo	seo˨ˀ˩ʔ
xẹp	sɛp˨ˀ˩
xẹt	sɛt˨ˀ˩
xẻ	sɛ˧˩˨
xẻn	sɛn˧˩˨
xẻng	sɛŋ˧˩˨
xẻo	seo˧˩˨
xẽo	seo˧ˀ˥
xế	se˨˦
xếch	sek˦˥
xếp	sep˦˥
xề	se˧˨
xềm	sem˧˨
xềnh	seŋ˧˨
xều	sɛu˧˨
xể	se˧˩˨
xểnh	seŋ˧˩˨
xệ	se˨ˀ˩ʔ
xệch	sek˨ˀ˩
xệp	sep˨ˀ˩
xệt	set˨ˀ˩
xệu	sɛu˨ˀ˩ʔ
xỉ	si˧˩˨
xỉa	siə˧˩˨
xỉn	sin˧˩˨
xỉnh	siŋ˧˩˨
xỉu	siw˧˩˨
xị	si˨ˀ˩ʔ
xịch	sik˨ˀ˩
xịn	sin˨ˀ˩ʔ
xịt	sit˨ˀ˩
xịu	siw˨ˀ˩ʔ
xọ	sɔ˨ˀ˩ʔ
xọc	sɔk͡p˨ˀ˩
xọe	swe˨ˀ˩ʔ
xọp	sɔp˨ˀ˩
xỏ	sɔ˧˩˨
xỏa	swa˧˩˨
xỏng	sɔŋ͡m˧˩˨
xố	so˨˦
xốc	sok͡p˦˥
xối	soj˨˦
xốn	son˨˦
xống	soŋ͡m˨˦
xốp	sop˦˥
xốt	sot˦˥
xồ	so˧˨
xồm	som˧˨
xồn	son˧˨
xồng	soŋ͡m˧˨
xổ	so˧˩˨
xổi	soj˧˩˨
xổm	som˧˩˨
xổn	son˧˩˨
xổng	soŋ͡m˧˩˨
xộc	sok͡p˨ˀ˩
xộn	son˨ˀ˩ʔ
xộp	sop˨ˀ˩
xớ	sɤ˨˦
xới	sɤj˨˦
xớn	sɤn˨˦
xớp	sɤp˦˥
xớt	sɤt˦˥
xờ	sɤ˧˨
xờm	sɤm˧˨
xở	sɤ˧˩˨
xởi	sɤj˧˩˨
xởn	sɤn˧˩˨
xỡ	sɤ˧ˀ˥
xợp	sɤp˨ˀ˩
xợt	sɤt˨ˀ˩
xụ	su˨ˀ˩ʔ
xục	suk͡p˨ˀ˩
xụi	suj˨ˀ˩ʔ
xụng	suŋ͡m˨ˀ˩ʔ
xụp	sup˨ˀ˩
xụt	sut˨ˀ˩
xủ	su˧˩˨
xủng	suŋ͡m˧˩˨
xứ	sɯ˨˦
xức	sɯk˦˥
xứng	sɯŋ˨˦
xừ	sɯ˧˨
xừng	sɯŋ˧˨
xử	sɯ˧˩˨
xửa	sɯə˧˩˨
xửng	sɯŋ˧˩˨
xự	sɯ˨ˀ˩ʔ
xực	sɯk˨ˀ˩
y	i˧˧
yêm	iɛm˧˧
yên	iɛn˧˧
yêng	iɛŋ˧˧
yêu	iəw˧˧
yếm	iɛm˨˦
yến	iɛn˨˦
yết	iɛt˦˥
yếu	iəw˨˦
yểm	iɛm˧˩˨
yểng	iɛŋ˧˩˨
yểu	iəw˧˩˨
à	a˧˨
ành	ɛŋ˧˨
ào	aw˧˨
á	a˨˦
ác	ak˦˥
ách	ɛk˦˥
ái	aj˨˦
ám	am˨˦
án	an˨˦
áng	aŋ˨˦
ánh	ɛŋ˨˦
áo	aw˨˦
áp	ap˦˥
át	at˦˥
áy	ăj˨˦
â	ɤ̆˧˧
âm	ɤ̆m˧˧
ân	ɤ̆n˧˧
âu	ɤ̆w˧˧
ây	ɤ̆j˧˧
ã	a˧ˀ˥
è	ɛ˧˨
èng	ɛŋ˧˨
èo	eo˧˨
é	ɛ˨˦
éc	ɛk˦˥
ém	ɛm˨˦
én	ɛn˨˦
éo	eo˨˦
ép	ɛp˦˥
ét	ɛt˦˥
ê	e˧˧
êm	em˧˧
êu	ɛu˧˧
ì	i˧˨
ìn	in˧˨
ình	iŋ˧˨
í	i˨˦
ích	ik˦˥
ín	in˨˦
ít	it˦˥
ò	ɔ˧˨
òa	wa˧˨
òi	ɔj˧˨
òm	ɔm˧˨
òn	ɔn˧˨
òng	ɔŋ͡m˧˨
ó	ɔ˨˦
óc	ɔk͡p˦˥
óe	we˨˦
ói	ɔj˨˦
óng	ɔŋ͡m˨˦
óp	ɔp˦˥
ót	ɔt˦˥
ô	o˧˧
ôi	oj˧˧
ôm	om˧˧
ôn	on˧˧
ông	oŋ͡m˧˧
õng	ɔŋ͡m˧ˀ˥
ù	u˧˨
ùa	uə˧˨
ùm	um˧˨
ùn	un˧˨
ùng	uŋ͡m˧˨
ú	u˨˦
úa	uə˨˦
úc	uk͡p˦˥
úi	uj˨˦
úm	um˨˦
úng	uŋ͡m˨˦
úp	up˦˥
út	ut˦˥
úy	wi˨˦
ý	i˨˦
ă	ă˧˧
ăm	ăm˧˧
ăn	ăn˧˧
ăng	ăŋ˧˧
đa	da˧˧
đai	daj˧˧
đam	dam˧˧
đan	dan˧˧
đang	daŋ˧˧
đanh	dɛŋ˧˧
đao	daw˧˧
đau	dăw˧˧
đay	dăj˧˧
đe	dɛ˧˧
đem	dɛm˧˧
đen	dɛn˧˧
đeng	dɛŋ˧˧
đeo	deo˧˧
đi	di˧˧
đin	din˧˧
đinh	diŋ˧˧
đip	dip˧˧
điu	diw˧˧
điên	diən˧˧
điêng	diəŋ˧˧
điêu	diəw˧˧
điếc	diək˦˥
điếm	diəm˨˦
điến	diən˨˦
điếng	diəŋ˨˦
điếu	diəw˨˦
điềm	diəm˧˨
điền	diən˧˨
điều	diəw˧˨
điểm	diəm˧˩˨
điển	diən˧˩˨
điểu	diəw˧˩˨
điệm	diəm˨ˀ˩ʔ
điện	diən˨ˀ˩ʔ
điệp	diəp˨ˀ˩
điệu	diəw˨ˀ˩ʔ
đo	dɔ˧˧
đoan	dwan˧˧
đoi	dɔj˧˧
đom	dɔm˧˧
đon	dɔn˧˧
đong	dɔŋ͡m˧˧
đoài	dwaj˧˨
đoàn	dwan˧˨
đoàng	dwaŋ˧˨
đoành	dwɛŋ˧˨
đoá	dwa˨˦
đoác	dwak˦˥
đoái	dwaj˨˦
đoán	dwan˨˦
đoãng	dwaŋ˧ˀ˥
đoạ	dwa˨ˀ˩ʔ
đoạn	dwan˨ˀ˩ʔ
đoạt	dwat˨ˀ˩
đoản	dwan˧˩˨
đoảng	dwaŋ˧˩˨
đu	du˧˧
đua	duə˧˧
đui	duj˧˧
đum	dum˧˧
đun	dun˧˧
đung	duŋ͡m˧˧
đup	dup˧˧
đuy	dwi˧˧
đuya	dwiə˧˧
đuôi	duəj˧˧
đuôn	duən˧˧
đuông	duəŋ˧˧
đuềnh	dweŋ˧˨
đuểnh	dweŋ˧˩˨
đuễnh	dweŋ˧ˀ˥
đuốc	duək˦˥
đuối	duəj˨˦
đuống	duəŋ˨˦
đuồn	duən˧˨
đuổi	duəj˧˩˨
đuỗn	duən˧ˀ˥
đuột	duət˨ˀ˩
đuờng	duəŋ˧˨
đà	da˧˨
đài	daj˧˨
đàm	dam˧˨
đàn	dan˧˨
đàng	daŋ˧˨
đành	dɛŋ˧˨
đào	daw˧˨
đày	dăj˧˨
đá	da˨˦
đác	dak˦˥
đách	dɛk˦˥
đái	daj˨˦
đám	dam˨˦
đán	dan˨˦
đáng	daŋ˨˦
đánh	dɛŋ˨˦
đáo	daw˨˦
đáp	dap˦˥
đát	dat˦˥
đáu	dăw˨˦
đáy	dăj˨˦
đâm	dɤ̆m˧˧
đâng	dɤ̆ŋ˧˧
đâu	dɤ̆w˧˧
đây	dɤ̆j˧˧
đã	da˧ˀ˥
đãi	daj˧ˀ˥
đãng	daŋ˧ˀ˥
đãy	dăj˧ˀ˥
đè	dɛ˧˨
đèm	dɛm˧˨
đèn	dɛn˧˨
đèo	deo˧˨
đé	dɛ˨˦
đéc	dɛk˦˥
đém	dɛm˨˦
đéo	deo˨˦
đét	dɛt˦˥
đê	de˧˧
đêm	dem˧˧
đên	den˧˧
đênh	deŋ˧˧
đêu	dɛu˧˧
đì	di˧˨
đìa	diə˧˨
đìn	din˧˨
đình	diŋ˧˨
đìu	diw˧˨
đí	di˨˦
đía	diə˨˦
đích	dik˦˥
đính	diŋ˨˦
đíp	dip˦˥
đít	dit˦˥
đò	dɔ˧˨
đòi	dɔj˧˨
đòm	dɔm˧˨
đòn	dɔn˧˨
đòng	dɔŋ͡m˧˨
đó	dɔ˨˦
đóa	dwa˨˦
đóc	dɔk͡p˦˥
đói	dɔj˨˦
đóm	dɔm˨˦
đón	dɔn˨˦
đóng	dɔŋ͡m˨˦
đóp	dɔp˦˥
đót	dɔt˦˥
đô	do˧˧
đôi	doj˧˧
đôm	dom˧˧
đôn	don˧˧
đông	doŋ͡m˧˧
đõ	dɔ˧ˀ˥
đù	du˧˨
đùa	duə˧˨
đùi	duj˧˨
đùm	dum˧˨
đùn	dun˧˨
đùng	duŋ͡m˧˨
đú	du˨˦
đúa	duə˨˦
đúc	duk͡p˦˥
đúm	dum˨˦
đún	dun˨˦
đúng	duŋ͡m˨˦
đúp	dup˦˥
đút	dut˦˥
đăm	dăm˧˧
đăng	dăŋ˧˧
đĩ	di˧ˀ˥
đĩa	diə˧ˀ˥
đĩnh	diŋ˧ˀ˥
đũa	duə˧ˀ˥
đũi	duj˧ˀ˥
đũng	duŋ͡m˧ˀ˥
đơ	dɤ˧˧
đơm	dɤm˧˧
đơn	dɤn˧˧
đưa	dɯə˧˧
đưng	dɯŋ˧˧
đương	dɯəŋ˧˧
đước	dɯək˦˥
đướu	dɯəw˨˦
đười	dɯəj˧˨
đườn	dɯən˧˨
đường	dɯəŋ˧˨
đưỡn	dɯən˧ˀ˥
được	dɯək˨ˀ˩
đượi	dɯəj˨ˀ˩ʔ
đượm	dɯəm˨ˀ˩ʔ
đạc	dak˨ˀ˩
đạch	dɛk˨ˀ˩
đại	daj˨ˀ˩ʔ
đạm	dam˨ˀ˩ʔ
đạn	dan˨ˀ˩ʔ
đạo	daw˨ˀ˩ʔ
đạp	dap˨ˀ˩
đạt	dat˨ˀ˩
đả	da˧˩˨
đảm	dam˧˩˨
đản	dan˧˩˨
đảng	daŋ˧˩˨
đảnh	dɛŋ˧˩˨
đảo	daw˧˩˨
đảy	dăj˧˩˨
đấm	dɤ̆m˨˦
đấng	dɤ̆ŋ˨˦
đất	dɤ̆t˦˥
đấu	dɤ̆w˨˦
đấy	dɤ̆j˨˦
đầm	dɤ̆m˧˨
đần	dɤ̆n˧˨
đầu	dɤ̆w˧˨
đầy	dɤ̆j˧˨
đẩu	dɤ̆w˧˩˨
đẩy	dɤ̆j˧˩˨
đẫm	dɤ̆m˧ˀ˥
đẫn	dɤ̆n˧ˀ˥
đẫy	dɤ̆j˧ˀ˥
đậm	dɤ̆m˨ˀ˩ʔ
đận	dɤ̆n˨ˀ˩ʔ
đập	dɤ̆p˨ˀ˩
đật	dɤ̆t˨ˀ˩
đậu	dɤ̆w˨ˀ˩ʔ
đậy	dɤ̆j˨ˀ˩ʔ
đắc	dăk˦˥
đắm	dăm˨˦
đắn	dăn˨˦
đắng	dăŋ˨˦
đắp	dăp˦˥
đắt	dăt˦˥
đằm	dăm˧˨
đằn	dăn˧˨
đằng	dăŋ˧˨
đẳng	dăŋ˧˩˨
đẵm	dăm˧ˀ˥
đẵn	dăn˧ˀ˥
đẵng	dăŋ˧ˀ˥
đặc	dăk˨ˀ˩
đặm	dăm˨ˀ˩ʔ
đặn	dăn˨ˀ˩ʔ
đặng	dăŋ˨ˀ˩ʔ
đặt	dăt˨ˀ˩
đẹn	dɛn˨ˀ˩ʔ
đẹp	dɛp˨ˀ˩
đẹt	dɛt˨ˀ˩
đẻ	dɛ˧˩˨
đẽ	dɛ˧ˀ˥
đẽo	deo˧ˀ˥
đế	de˨˦
đếch	dek˦˥
đếm	dem˨˦
đến	den˨˦
đề	de˧˨
đềm	dem˧˨
đền	den˧˨
đềnh	deŋ˧˨
đều	dɛu˧˨
để	de˧˩˨
đểm	dem˧˩˨
đểnh	deŋ˧˩˨
đểu	dɛu˧˩˨
đễ	de˧ˀ˥
đễnh	deŋ˧ˀ˥
đệ	de˨ˀ˩ʔ
đệm	dem˨ˀ˩ʔ
đệp	dep˨ˀ˩
đỉa	diə˧˩˨
đỉnh	diŋ˧˩˨
địa	diə˨ˀ˩ʔ
địch	dik˨ˀ˩
định	diŋ˨ˀ˩ʔ
địt	dit˨ˀ˩
địu	diw˨ˀ˩ʔ
đọ	dɔ˨ˀ˩ʔ
đọa	dwa˨ˀ˩ʔ
đọc	dɔk͡p˨ˀ˩
đọi	dɔj˨ˀ˩ʔ
đọn	dɔn˨ˀ˩ʔ
đọng	dɔŋ͡m˨ˀ˩ʔ
đọp	dɔp˨ˀ˩
đọt	dɔt˨ˀ˩
đỏ	dɔ˧˩˨
đỏi	dɔj˧˩˨
đỏm	dɔm˧˩˨
đỏng	dɔŋ͡m˧˩˨
đố	do˨˦
đốc	dok͡p˦˥
đối	doj˨˦
đốm	dom˨˦
đốn	don˨˦
đống	doŋ͡m˨˦
đốp	dop˦˥
đốt	dot˦˥
đồ	do˧˨
đồi	doj˧˨
đồm	dom˧˨
đồn	don˧˨
đồng	doŋ͡m˧˨
đổ	do˧˩˨
đổi	doj˧˩˨
đổng	doŋ͡m˧˩˨
đỗ	do˧ˀ˥
đỗi	doj˧ˀ˥
độ	do˨ˀ˩ʔ
độc	dok͡p˨ˀ˩
đội	doj˨ˀ˩ʔ
độn	don˨ˀ˩ʔ
động	doŋ͡m˨ˀ˩ʔ
độp	dop˨ˀ˩
đột	dot˨ˀ˩
đớ	dɤ˨˦
đới	dɤj˨˦
đớn	dɤn˨˦
đớp	dɤp˦˥
đớt	dɤt˦˥
đờ	dɤ˧˨
đời	dɤj˧˨
đờm	dɤm˧˨
đờn	dɤn˧˨
đởm	dɤm˧˩˨
đởn	dɤn˧˩˨
đỡ	dɤ˧ˀ˥
đợ	dɤ˨ˀ˩ʔ
đợi	dɤj˨ˀ˩ʔ
đợp	dɤp˨ˀ˩
đợt	dɤt˨ˀ˩
đụ	du˨ˀ˩ʔ
đục	duk͡p˨ˀ˩
đụi	duj˨ˀ˩ʔ
đụn	dun˨ˀ˩ʔ
đụng	duŋ͡m˨ˀ˩ʔ
đụp	dup˨ˀ˩
đụt	dut˨ˀ˩
đủ	du˧˩˨
đủi	duj˧˩˨
đủng	duŋ͡m˧˩˨
đứ	dɯ˨˦
đứa	dɯə˨˦
đức	dɯk˦˥
đứng	dɯŋ˨˦
đứt	dɯt˦˥
đừ	dɯ˧˨
đừa	dɯə˧˨
đừng	dɯŋ˧˨
đử	dɯ˧˩˨
đực	dɯk˨ˀ˩
đựng	dɯŋ˨ˀ˩ʔ
ĩ	i˧ˀ˥
ĩnh	iŋ˧ˀ˥
ơ	ɤ˧˧
ơi	ɤj˧˧
ơn	ɤn˧˧
ư	ɯ˧˧
ưa	ɯə˧˧
ưng	ɯŋ˧˧
ưu	ɯw˧˧
ươi	ɯəj˧˧
ươm	ɯəm˧˧
ươn	ɯən˧˧
ương	ɯəŋ˧˧
ước	ɯək˦˥
ướm	ɯəm˨˦
ướp	ɯəp˦˥
ướt	ɯət˦˥
ườn	ɯən˧˨
ưỡn	ɯən˧ˀ˥
ạ	a˨ˀ˩ʔ
ạch	ɛk˨ˀ˩
ạnh	ɛŋ˨ˀ˩ʔ
ạo	aw˨ˀ˩ʔ
ạt	at˨ˀ˩
ả	a˧˩˨
ải	aj˧˩˨
ảm	am˧˩˨
ảng	aŋ˧˩˨
ảnh	ɛŋ˧˩˨
ảo	aw˧˩˨
ấm	ɤ̆m˨˦
ấn	ɤ̆n˨˦
ấp	ɤ̆p˦˥
ất	ɤ̆t˦˥
ấu	ɤ̆w˨˦
ấy	ɤ̆j˨˦
ầm	ɤ̆m˧˨
ầng	ɤ̆ŋ˧˨
ầu	ɤ̆w˧˨
ầy	ɤ̆j˧˨
ẩm	ɤ̆m˧˩˨
ẩn	ɤ̆n˧˩˨
ẩng	ɤ̆ŋ˧˩˨
ẩu	ɤ̆w˧˩˨
ẩy	ɤ̆j˧˩˨
ẫm	ɤ̆m˧ˀ˥
ậc	ɤ̆k˨ˀ˩
ậm	ɤ̆m˨ˀ˩ʔ
ập	ɤ̆p˨ˀ˩
ậu	ɤ̆w˨ˀ˩ʔ
ắc	ăk˦˥
ắng	ăŋ˨˦
ắp	ăp˦˥
ắt	ăt˦˥
ằng	ăŋ˧˨
ẳng	ăŋ˧˩˨
ẵm	ăm˧ˀ˥
ặc	ăk˨ˀ˩
ặp	ăp˨ˀ˩
ẹ	ɛ˨ˀ˩ʔ
ẹc	ɛk˨ˀ˩
ẹo	eo˨ˀ˩ʔ
ẹp	ɛp˨ˀ˩
ẹt	ɛt˨ˀ˩
ẻn	ɛn˧˩˨
ẻo	eo˧˩˨
ẽo	eo˧ˀ˥
ế	e˨˦
ếch	ek˦˥
ếm	em˨˦
ếp	ep˦˥
ề	e˧˨
ềnh	eŋ˧˨
ễng	eŋ˧ˀ˥
ễnh	eŋ˧ˀ˥
ệ	e˨ˀ˩ʔ
ệch	ek˨ˀ˩
ện	en˨ˀ˩ʔ
ệnh	eŋ˨ˀ˩ʔ
ệp	ep˨ˀ˩
ệt	et˨ˀ˩
ỉ	i˧˩˨
ỉa	iə˧˩˨
ỉm	im˧˩˨
ỉn	in˧˩˨
ỉu	iw˧˩˨
ị	i˨ˀ˩ʔ
ịch	ik˨ˀ˩
ịn	in˨ˀ˩ʔ
ịt	it˨ˀ˩
ọ	ɔ˨ˀ˩ʔ
ọc	ɔk͡p˨ˀ˩
ọe	we˨ˀ˩ʔ
ọi	ɔj˨ˀ˩ʔ
ọp	ɔp˨ˀ˩
ọt	ɔt˨ˀ˩
ỏc	ɔk͡p˧˩˨
ỏe	we˧˩˨
ỏi	ɔj˧˩˨
ỏm	ɔm˧˩˨
ỏn	ɔn˧˩˨
ỏng	ɔŋ͡m˧˩˨
ố	o˨˦
ốc	ok͡p˦˥
ối	oj˨˦
ốm	om˨˦
ống	oŋ͡m˨˦
ốp	op˦˥
ốt	ot˦˥
ồ	o˧˨
ồi	oj˧˨
ồm	om˧˨
ồn	on˧˨
ồng	oŋ͡m˧˨
ổ	o˧˩˨
ổi	oj˧˩˨
ổm	om˧˩˨
ổn	on˧˩˨
ổng	oŋ͡m˧˩˨
ộ	o˨ˀ˩ʔ
ộc	ok͡p˨ˀ˩
ộn	on˨ˀ˩ʔ
ộp	op˨ˀ˩
ớ	ɤ˨˦
ới	ɤj˨˦
ớm	ɤm˨˦
ớn	ɤn˨˦
ớt	ɤt˦˥
ờ	ɤ˧˨
ời	ɤj˧˨
ờn	ɤn˧˨
ở	ɤ˧˩˨
ởn	ɤn˧˩˨
ỡm	ɤm˧ˀ˥
ợ	ɤ˨ˀ˩ʔ
ợi	ɤj˨ˀ˩ʔ
ợt	ɤt˨ˀ˩
ụ	u˨ˀ˩ʔ
ụa	uə˨ˀ˩ʔ
ục	uk͡p˨ˀ˩
ụp	up˨ˀ˩
ụt	ut˨ˀ˩
ủ	u˧˩˨
ủa	uə˧˩˨
ủi	uj˧˩˨
ủn	un˧˩˨
ủng	uŋ͡m˧˩˨
ủy	wi˧˩˨
ứ	ɯ˨˦
ứa	ɯə˨˦
ức	ɯk˦˥
ứng	ɯŋ˨˦
ừ	ɯ˧˨
ừng	ɯŋ˧˨
ử	ɯ˧˩˨
ửng	ɯŋ˧˩˨
ựa	ɯə˨ˀ˩ʔ
ực	ɯk˨ˀ˩
ỳ	i˧˨
ỷ	i˧˩˨
zalo	za˧˧lo˧˧
ava	a˧˧va˧˧
tivi	ti˧˧vi˧˧
axit	a˧˧sit˦˥
dịnh	ziŋ˨ˀ˩ʔ
phấm	fɤ̆m˨˦
bazo	ba˧˧zɤ˧˧
kilomet	ki˧˧lo˧˧mɛt˦˥
milimet	mi˧˧li˧˧mɛt˦˥
roai	rwaj˧˧
èn	ɛn˧˨
guôn	ɣuən˧˧
kông	koŋ͡m˧˧
đép	dɛp˦˥
pây	pɤ̆j˧˧
mừn	mɯn˧˨
pớt	pɤt˦˥
giút	zut˦˥
gióp	zɔp˦˥
dừn	zɯn˧˨
cừn	kɯn˧˨
đừn	dɯn˧˨
viu	viw˧˧
biu	biw˧˧
rếc	rek˦˥
piu	piw˧˧
pồ	po˧˨
từm	tɯm˧˨
pút	put˦˥
síp	sip˦˥
phơm	fɤm˧˧
ừn	ɯn˧˨
đết	det˦˥
sợp	sɤp˨ˀ˩
ết	et˦˥
thừn	tʰɯn˧˨
zai	zaj˧˧
fai	faj˧˧
hép	hɛp˦˥
guốt	ɣuət˦˥
goép	ɣwep˦˥
pót	pɔt˦˥
vừn	vɯn˧˨
rừn	rɯn˧˨
ciu	kiw˧˧
chắng	căŋ˨˦
vỹ	vi˧ˀ˥
lềm	lem˧˨
đim	dim˧˧
uân	wɤ̆n˧˧
kơ	kɤ˧˧
thớp	tʰɤp˦˥
nhiêng	ɲiəŋ˧˧
pé	pɛ˨˦
khằm	xăm˧˨
sỳ	si˧˨
khưu	xɯw˧˧
chử	cɯ˧˩˨
diếm	ziəm˨˦
iết	iət˦˥
ưi	ɯj˧˧
vơn	vɤn˧˧
ngoẩy	ŋwɤ̆j˧˩˨
giổ	zo˧˩˨
triểu	ciəw˧˩˨
giử	zɯ˧˩˨
quôm	kwom˧˧
dem	zɛm˧˧
dỡn	zɤn˧ˀ˥
xuôm	suəm˧˧
ươu	ɯəw˧˧
dớt	zɤt˦˥
khẹt	xɛt˨ˀ˩
pẩu	pɤ̆w˧˩˨
ngoào	ŋwaw˧˨
đắk	dăk˦˥
gòi	ɣɔj˧˨
nẩm	nɤ̆m˧˩˨
ràm	ram˧˨
khỡi	xɤj˧ˀ˥
cứi	kɯj˨˦
nguyến	ŋwiən˨˦
sốm	som˨˦
ruỗi	ruəj˧ˀ˥
tõe	twe˧ˀ˥
lêm	lem˧˧
lến	len˨˦
pí	pi˨˦
phóp	fɔp˦˥
pềnh	peŋ˧˨
lỏe	lwe˧˩˨
nhuốt	ɲuət˦˥
chổ	co˧˩˨
huôi	huəj˧˧
thuyển	tʰwiən˧˩˨
choẻn	cwen˧˩˨
hiêu	hiəw˧˧
ẽ	ɛ˧ˀ˥
trư	cɯ˧˧
pành	pɛŋ˧˨
quýu	kwiu˨˦
viễng	viəŋ˧ˀ˥
quô	kwo˧˧
đoa	dwa˧˧
riễn	riən˧ˀ˥
xuyền	swiən˧˨
xai	saj˧˧
nững	nɯŋ˧ˀ˥
mớt	mɤt˦˥
hốp	hop˦˥
giót	zɔt˦˥
ướn	ɯən˨˦
dùm	zum˧˨
nhướp	ɲɯəp˦˥
phền	fen˧˨
nựa	nɯə˨ˀ˩ʔ
vàu	văw˧˨
đãm	dam˧ˀ˥
nhưn	ɲɯn˧˧
loãn	lwan˧ˀ˥
nuê	nwe˧˧
xĩn	sin˧ˀ˥
duẩn	zwɤ̆n˧˩˨
đở	dɤ˧˩˨
kiển	kiən˧˩˨
chôi	coj˧˧
khỗ	xo˧ˀ˥
thuýt	tʰwit˦˥
luynh	lwiŋ˧˧
quíu	kwiw˨˦
nhòi	ɲɔj˧˨
vừ	vɯ˧˨
luỳnh	lwiŋ˧˨
noạn	nwan˨ˀ˩ʔ
xìn	sin˧˨
nghiễu	ŋiəw˧ˀ˥
dợi	zɤj˨ˀ˩ʔ
mỳ	mi˧˨
ạc	ak˨ˀ˩
khọc	xɔk͡p˨ˀ˩
quộc	kwok͡p˨ˀ˩
rẻn	rɛn˧˩˨
ghìn	ɣin˧˨
thếnh	tʰeŋ˨˦
ớp	ɤp˦˥
vộc	vok͡p˨ˀ˩
tiểng	tiəŋ˧˩˨
truệ	cwe˨ˀ˩ʔ
ể	e˧˩˨
ngằm	ŋăm˧˨
khụm	xum˨ˀ˩ʔ
khày	xăj˧˨
rọp	rɔp˨ˀ˩
ngưỡi	ŋɯəj˧ˀ˥
trể	ce˧˩˨
ngễu	ŋɛu˧ˀ˥
khuyễn	xwiən˧ˀ˥
giét	zɛt˦˥
ny	ni˧˧
sợt	sɤt˨ˀ˩
thởi	tʰɤj˧˩˨
khẫn	xɤ̆n˧ˀ˥
lóa	lwa˨˦
hía	hiə˨˦
sếch	sek˦˥
nhuôn	ɲuən˧˧
sép	sɛp˦˥
giúc	zuk͡p˦˥
soay	swăj˧˧
vốt	vot˦˥
đớm	dɤm˨˦
bềm	bem˧˨
dơm	zɤm˧˧
huyn	hwin˧˧
ua	uə˧˧
điểng	diəŋ˧˩˨
xảng	saŋ˧˩˨
đân	dɤ̆n˧˧
đạ	da˨ˀ˩ʔ
duyện	zwiən˨ˀ˩ʔ
quyềnh	kwiɛŋ˧˨
quép	kwɛp˦˥
sôn	son˧˧
dòn	zɔn˧˨
míc	mik˦˥
phởi	fɤj˧˩˨
ghiềm	ɣiəm˧˨
nặm	năm˨ˀ˩ʔ
cững	kɯŋ˧ˀ˥
sem	sɛm˧˧
oắm	wăm˨˦
hắp	hăp˦˥
loẳn	lwăn˧˩˨
mẻng	mɛŋ˧˩˨
lắk	lăk˦˥
phượt	fɯət˨ˀ˩
ngúm	ŋum˨˦
khưng	xɯŋ˧˧
triễn	ciən˧ˀ˥
gú	ɣu˨˦
rội	roj˨ˀ˩ʔ
sỏm	sɔm˧˩˨
peo	peo˧˧
buê	bwe˧˧
phíu	fiw˨˦
đấp	dɤ̆p˦˥
sừa	sɯə˧˨
tré	cɛ˨˦
pùa	puə˧˨
dớm	zɤm˨˦
mín	min˨˦
giạo	zaw˨ˀ˩ʔ
nướu	nɯəw˨˦
sỉn	sin˧˩˨
mũn	mun˧ˀ˥
rấy	rɤ̆j˨˦
gọp	ɣɔp˨ˀ˩
chẩy	cɤ̆j˧˩˨
bim	bim˧˧
vép	vɛp˦˥
uôn	uən˧˧
duê	zwe˧˧
chuya	cwiə˧˧
ghem	ɣɛm˧˧
nghoèo	ŋwew˧˨
chiểng	ciəŋ˧˩˨
boi	bɔj˧˧
nhũm	ɲum˧ˀ˥
mìu	miw˧˨
hửu	hɯw˧˩˨
siên	siən˧˧
súa	suə˨˦
nỷ	ni˧˩˨
ngét	ŋɛt˦˥
lỉa	liə˧˩˨
khây	xɤ̆j˧˧
quâng	kwɤ̆ŋ˧˧
xiêng	siəŋ˧˧
ngẵn	ŋăn˧ˀ˥
khẵng	xăŋ˧ˀ˥
lỏ	lɔ˧˩˨
gãng	ɣaŋ˧ˀ˥
vầm	vɤ̆m˧˨
nghia	ŋiə˧˧
xoán	swan˨˦
phưu	fɯw˧˧
sẳn	săn˧˩˨
sừ	sɯ˧˨
chịch	cik˨ˀ˩
oặng	wăŋ˨ˀ˩ʔ
uốt	uət˦˥
soắn	swăn˨˦
lơm	lɤm˧˧
róp	rɔp˦˥
phẫy	fɤ̆j˧ˀ˥
pù	pu˧˨
sổm	som˧˩˨
dưởng	zɯəŋ˧˩˨
riệu	riəw˨ˀ˩ʔ
trỉnh	ciŋ˧˩˨
pứa	pɯə˨˦
tùa	tuə˧˨
lỳ	li˧˨
sởm	sɤm˧˩˨
ruội	ruəj˨ˀ˩ʔ
tuôi	tuəj˧˧
hoanh	hwɛŋ˧˧
rôi	roj˧˧
sẵng	săŋ˧ˀ˥
ngoằm	ŋwăm˧˨
réc	rɛk˦˥
tiển	tiən˧˩˨
miểu	miəw˧˩˨
ngỗn	ŋon˧ˀ˥
rỳ	ri˧˨
pôn	pon˧˧
hoằng	hwăŋ˧˨
bẹc	bɛk˨ˀ˩
siếm	siəm˨˦
múng	muŋ͡m˨˦
thiệc	tʰiək˨ˀ˩
mủa	muə˧˩˨
siển	siən˧˩˨
nhuồm	ɲuəm˧˨
giép	zɛp˦˥
nhạ	ɲa˨ˀ˩ʔ
gioãng	zwaŋ˧ˀ˥
điễm	diəm˧ˀ˥
bãnh	bɛŋ˧ˀ˥
uơ	uə˧˧
siệng	siəŋ˨ˀ˩ʔ
gới	ɣɤj˨˦
thúp	tʰup˦˥
khường	xɯəŋ˧˨
chóa	cwa˨˦
soạch	swɛk˨ˀ˩
bíc	bik˦˥
trõ	cɔ˧ˀ˥
hưm	hɯm˧˧
niếng	niəŋ˨˦
dãng	zaŋ˧ˀ˥
mơm	mɤm˧˧
quơn	kwɤn˧˧
ơu	ɤw˧˧
quớt	kwɤt˦˥
nhềnh	ɲeŋ˧˨
sịp	sip˨ˀ˩
nghiểu	ŋiəw˧˩˨
thỗ	tʰo˧ˀ˥
quợc	kwɤk˨ˀ˩
dụa	zuə˨ˀ˩ʔ
thuẩn	tʰwɤ̆n˧˩˨
luềnh	lweŋ˧˨
đị	di˨ˀ˩ʔ
mợp	mɤp˨ˀ˩
mõi	mɔj˧ˀ˥
dánh	zɛŋ˨˦
quôn	kwon˧˧
síu	siw˨˦
uôi	uəj˧˧
sế	se˨˦
giuông	zuəŋ˧˧
trặt	căt˨ˀ˩
bừn	bɯn˧˨
kện	ken˨ˀ˩ʔ
ngọa	ŋwa˨ˀ˩ʔ
đia	diə˧˧
khốt	xot˦˥
ngởi	ŋɤj˧˩˨
dèm	zɛm˧˨
mưỡu	mɯəw˧ˀ˥
thổng	tʰoŋ͡m˧˩˨
ỹ	i˧ˀ˥
huyến	hwiən˨˦
béch	bɛk˦˥
xạt	sat˨ˀ˩
nhộm	ɲom˨ˀ˩ʔ
khuều	xwəw˧˨
mỵ	mi˨ˀ˩ʔ
phĩ	fi˧ˀ˥
bếch	bek˦˥
cằng	kăŋ˧˨
chuân	cwɤ̆n˧˧
cờm	kɤm˧˨
miềng	miəŋ˧˨
thỏng	tʰɔŋ͡m˧˩˨
khần	xɤ̆n˧˨
xư	sɯ˧˧
thuất	tʰwɤ̆t˦˥
sữu	sɯw˧ˀ˥
sí	si˨˦
ngẩy	ŋɤ̆j˧˩˨
sển	sen˧˩˨
ghích	ɣik˦˥
pó	pɔ˨˦
khim	xim˧˧
rững	rɯŋ˧ˀ˥
ngoặm	ŋwăm˨ˀ˩ʔ
mảo	maw˧˩˨
nhởm	ɲɤm˧˩˨
giỡ	zɤ˧ˀ˥
khột	xot˨ˀ˩
tễu	tɛu˧ˀ˥
mừa	mɯə˧˨
xuông	suəŋ˧˧
nởi	nɤj˧˩˨
đỉ	di˧˩˨
pheng	fɛŋ˧˧
dôm	zom˧˧
gui	ɣuj˧˧
giứt	zɯt˦˥
hoản	hwan˧˩˨
nhệt	ɲet˨ˀ˩
pía	piə˨˦
nhếnh	ɲeŋ˨˦
nghêng	ŋeŋ˧˧
vắp	văp˦˥
chuỗn	cuən˧ˀ˥
ụn	un˨ˀ˩ʔ
nềm	nem˧˨
nhuộn	ɲuən˨ˀ˩ʔ
tríp	cip˦˥
hới	hɤj˨˦
xuyệt	swiət˨ˀ˩
doạc	zwak˨ˀ˩
riếp	riəp˦˥
pín	pin˨˦
bứu	bɯw˨˦
oét	wet˦˥
ry	ri˧˧
hẹc	hɛk˨ˀ˩
ngụn	ŋun˨ˀ˩ʔ
oảnh	wɛŋ˧˩˨
nươi	nɯəj˧˧
giy	zi˧˧
phuốt	fuət˦˥
suề	swe˧˨
ươ	ɯə˧˧
đẻn	dɛn˧˩˨
nhiệu	ɲiəw˨ˀ˩ʔ
phiêng	fiəŋ˧˧
chợm	cɤm˨ˀ˩ʔ
trẹm	cɛm˨ˀ˩ʔ
duân	zwɤ̆n˧˧
riều	riəw˧˨
ún	un˨˦
sơi	sɤj˧˧
nụt	nut˨ˀ˩
ghêm	ɣem˧˧
nộc	nok͡p˨ˀ˩
phõ	fɔ˧ˀ˥
nhết	ɲet˦˥
rãn	ran˧ˀ˥
víp	vip˦˥
giùng	zuŋ͡m˧˨
xại	saj˨ˀ˩ʔ
thòn	tʰɔn˧˨
chiệng	ciəŋ˨ˀ˩ʔ
ển	en˧˩˨
uê	we˧˧
iêu	iəw˧˧
rèng	rɛŋ˧˨
thạt	tʰat˨ˀ˩
chĩu	ciw˧ˀ˥
xân	sɤ̆n˧˧
sệu	sɛu˨ˀ˩ʔ
giêm	zem˧˧
